,Player Name,From,To,Years in NBA,Primary Position,Secondary Postion
0,Alaa Abdelnaby,1991,1995,4,F,
1,Zaid Abdul-Aziz,1969,1978,9,C,F
2,Kareem Abdul-Jabbar*,1970,1989,19,C,
3,Mahmoud Abdul-Rauf,1991,2001,10,G,
4,Tariq Abdul-Wahad,1998,2003,5,F,
5,Shareef Abdur-Rahim,1997,2008,11,F,
6,Tom Abernethy,1977,1981,4,F,
7,Forest Able,1957,1957,0,G,
8,John Abramovic,1947,1948,1,F,
9,Álex Abrines,2017,2019,2,G,F
10,Precious Achiuwa,2021,2022,1,F,
11,Alex Acker,2006,2009,3,G,
12,Don Ackerman,1954,1954,0,G,
13,Mark Acres,1988,1993,5,F,C
14,Bud Acton,1968,1968,0,F,
15,Quincy Acy,2013,2019,6,F,C
16,Alvan Adams,1976,1988,12,C,F
17,Don Adams,1971,1977,6,F,
18,George Adams,1973,1975,2,F,G
19,Hassan Adams,2007,2009,2,G,
20,Jaylen Adams,2019,2021,2,G,
21,Jordan Adams,2015,2016,1,G,
22,Michael Adams,1986,1996,10,G,
23,Steven Adams,2014,2022,8,C,
24,Rafael Addison,1987,1997,10,F,G
25,Bam Adebayo,2018,2022,4,C,F
26,Deng Adel,2019,2019,0,F,
27,Rick Adelman*,1969,1975,6,G,
28,Jeff Adrien,2011,2015,4,F,
29,Arron Afflalo,2008,2018,10,G,F
30,Maurice Ager,2007,2011,4,G,
31,Mark Aguirre,1982,1994,12,F,G
32,Blake Ahearn,2008,2012,4,G,
33,Danny Ainge,1982,1995,13,G,
34,Matthew Aitch,1968,1968,0,F,
35,Alexis Ajinça,2009,2017,8,C,F
36,Henry Akin,1967,1969,2,C,F
37,Josh Akognon,2013,2013,0,G,
38,DeVaughn Akoon-Purcell,2019,2019,0,G,
39,Solomon Alabi,2011,2012,1,C,
40,Mark Alarie,1987,1991,4,F,
41,Gary Alcorn,1960,1961,1,C,
42,Santi Aldama,2022,2022,0,F,
43,Furkan Aldemir,2015,2015,0,F,C
44,Cole Aldrich,2011,2018,7,C,
45,LaMarcus Aldridge,2007,2022,15,F,C
46,Chuck Aleksinas,1985,1985,0,C,
47,Cliff Alexander,2016,2016,0,F,
48,Cory Alexander,1996,2005,9,G,
49,Courtney Alexander,2001,2003,2,G,
50,Gary Alexander,1994,1994,0,F,
51,Joe Alexander,2009,2010,1,F,
52,Kyle Alexander,2020,2020,0,F,
53,Ty-Shon Alexander,2021,2021,0,G,
54,Victor Alexander,1992,2002,10,C,F
55,Nickeil Alexander-Walker,2020,2022,2,G,
56,Steve Alford,1988,1991,3,G,
57,Rawle Alkins,2019,2019,0,G,
58,Bill Allen,1968,1968,0,C,F
59,Bob Allen,1969,1969,0,F,
60,Grayson Allen,2019,2022,3,G,
61,Jarrett Allen,2018,2022,4,C,F
62,Jerome Allen,1996,1997,1,G,
63,Kadeem Allen,2018,2020,2,G,
64,Lavoy Allen,2012,2017,5,F,C
65,Lucius Allen,1970,1979,9,G,
66,Malik Allen,2002,2011,9,F,C
67,Randy Allen,1989,1990,1,F,
68,Ray Allen*,1997,2014,17,G,
69,Tony Allen,2005,2018,13,G,F
70,Willie Allen,1972,1972,0,F,
71,Odis Allison,1972,1972,0,F,
72,Lance Allred,2008,2008,0,C,
73,Darrell Allums,1981,1981,0,F,
74,Morris Almond,2008,2012,4,G,
75,Derrick Alston,1995,1997,2,F,
76,Rafer Alston,2000,2010,10,G,
77,Peter Aluma,1999,1999,0,C,
78,Jose Alvarado,2022,2022,0,G,
79,John Amaechi,1996,2003,7,C,F
80,Ashraf Amaya,1996,1997,1,F,
81,Al-Farouq Aminu,2011,2021,10,F,
82,Lou Amundson,2007,2016,9,F,C
83,Bob Anderegg,1960,1960,0,F,G
84,Chris Andersen,2002,2017,15,C,F
85,David Andersen,2010,2011,1,C,
86,Alan Anderson,2006,2017,11,G,F
87,Andrew Anderson,1968,1970,2,G,
88,Antonio Anderson,2010,2010,0,G,
89,Cliff Anderson,1968,1971,3,G,F
90,Dan Anderson,1968,1969,1,C,
91,Dan Anderson,1975,1976,1,G,
92,Derek Anderson,1998,2008,10,G,
93,Dwight Anderson,1983,1983,0,G,
94,Eric Anderson,1993,1994,1,F,
95,Greg Anderson,1988,1998,10,F,C
96,J.J. Anderson,1983,1985,2,F,
97,James Anderson,2011,2016,5,G,F
98,Jerome Anderson,1976,1977,1,G,
99,Justin Anderson,2016,2022,6,G,
100,Kenny Anderson,1992,2005,13,G,
101,Kim Anderson,1979,1979,0,F,
102,Kyle Anderson,2015,2022,7,F,G
103,Michael Anderson,1989,1989,0,G,
104,Nick Anderson,1990,2002,12,F,G
105,Richard Anderson,1983,1990,7,F,C
106,Ron Anderson,1985,1994,9,F,G
107,Ryan Anderson,2009,2020,11,F,
108,Shandon Anderson,1997,2006,9,F,G
109,Willie Anderson,1989,1997,8,G,F
110,Wally Anderzunas,1970,1970,0,C,F
111,Martynas Andriuškevičius,2006,2006,0,C,
112,Don Anielak,1955,1955,0,F,
113,Ike Anigbogu,2018,2019,1,F,C
114,Michael Ansley,1990,1992,2,F,
115,Chris Anstey,1998,2000,2,C,
116,Giannis Antetokounmpo,2014,2022,8,F,G
117,Kostas Antetokounmpo,2019,2021,2,F,
118,Thanasis Antetokounmpo,2016,2022,6,F,
119,Carmelo Anthony,2004,2022,18,F,
120,Cole Anthony,2021,2022,1,G,
121,Greg Anthony,1992,2002,10,G,
122,Joel Anthony,2008,2017,9,C,
123,Pero Antić,2014,2015,1,C,F
124,OG Anunoby,2018,2022,4,F,
125,Keith Appling,2016,2016,0,G,
126,Rafael Araújo,2005,2007,2,C,
127,Stacey Arceneaux,1962,1962,0,F,
128,Robert Archibald,2003,2004,1,F,
129,Tiny Archibald*,1971,1984,13,G,
130,Ryan Arcidiacono,2018,2021,3,G,
131,Jim Ard,1971,1978,7,F,C
132,Gilbert Arenas,2002,2012,10,G,
133,Trevor Ariza,2005,2022,17,F,
134,Paul Arizin*,1951,1962,11,F,G
135,Joe Arlauckas,1988,1988,0,F,
136,B.J. Armstrong,1990,2000,10,G,
137,Bob Armstrong,1957,1957,0,C,F
138,Brandon Armstrong,2002,2004,2,G,
139,Curly Armstrong,1949,1951,2,G,F
140,Darrell Armstrong,1995,2008,13,G,
141,Hilton Armstrong,2007,2014,7,F,C
142,Tate Armstrong,1978,1979,1,G,
143,Jesse Arnelle,1956,1956,0,F,
144,Jay Arnette,1964,1966,2,G,
145,Bob Arnzen,1970,1974,4,F,
146,Carlos Arroyo,2002,2011,9,G,
147,Darrell Arthur,2009,2018,9,F,
148,John Arthurs,1970,1970,0,G,
149,Jamel Artis,2018,2018,0,G,F
150,Ömer Aşık,2011,2018,7,C,
151,Vincent Askew,1988,1998,10,G,F
152,Keith Askins,1991,1999,8,G,F
153,Don Asmonga,1954,1954,0,G,
154,Dick Atha,1956,1958,2,G,
155,Chucky Atkins,2000,2010,10,G,
156,Al Attles*,1961,1971,10,G,
157,Chet Aubuchon,1947,1947,0,G,
158,Stacey Augmon,1992,2006,14,F,G
159,D.J. Augustin,2009,2022,13,G,
160,James Augustine,2007,2008,1,F,
161,Isaac Austin,1992,2002,10,C,
162,Johnny Austin,1967,1968,1,G,
163,Ken Austin,1984,1984,0,F,
164,Deni Avdija,2021,2022,1,G,F
165,Anthony Avent,1993,2000,7,F,
166,Bird Averitt,1974,1978,4,G,
167,William Avery,2000,2002,2,G,
168,Dennis Awtrey,1971,1982,11,C,
169,Joel Ayayi,2022,2022,0,G,
170,Gustavo Ayón,2012,2014,2,C,
171,Jeff Ayres,2010,2016,6,F,
172,Deandre Ayton,2019,2022,3,C,
173,Kelenna Azubuike,2007,2012,5,G,
174,Udoka Azubuike,2021,2022,1,C,
175,Chris Babb,2014,2014,0,G,
176,Luke Babbitt,2011,2018,7,F,
177,Miloš Babić,1991,1992,1,C,F
178,Johnny Bach,1949,1949,0,F,G
179,Dwayne Bacon,2018,2021,3,G,
180,Henry Bacon,1973,1973,0,G,
181,Jim Baechtold,1953,1957,4,F,G
182,Dalibor Bagarić,2001,2003,2,C,
183,John Bagley,1983,1994,11,G,
184,Marvin Bagley III,2019,2022,3,F,C
185,Carl Bailey,1982,1982,0,C,
186,Gus Bailey,1975,1980,5,G,F
187,James Bailey,1980,1988,8,F,C
188,Thurl Bailey,1984,1999,15,F,C
189,Toby Bailey,1999,2000,1,G,
190,Cameron Bairstow,2015,2016,1,F,C
191,Jimmie Baker,1976,1976,0,F,
192,Mark Baker,1999,1999,0,G,
193,Maurice Baker,2005,2005,0,G,
194,Norm Baker,1947,1947,0,G,
195,Ron Baker,2017,2019,2,G,
196,Vin Baker,1994,2006,12,F,
197,Wade Baldwin,2017,2019,2,G,
198,Renaldo Balkman,2007,2012,5,F,
199,Cedric Ball,1991,1991,0,F,
200,LaMelo Ball,2021,2022,1,G,
201,Lonzo Ball,2018,2022,4,G,
202,Greg Ballard,1978,1989,11,F,
203,Herschel Baltimore,1947,1947,0,F,
204,Mo Bamba,2019,2022,3,C,
205,Desmond Bane,2021,2022,1,G,
206,Gene Banks,1982,1987,5,F,G
207,Marcus Banks,2004,2011,7,G,
208,Walker Banks,1971,1971,0,C,
209,Ken Bannister,1985,1991,6,F,C
210,Mike Bantom,1974,1982,8,F,C
211,Dalano Banton,2022,2022,0,G,F
212,Cat Barber,2022,2022,0,G,
213,John Barber,1957,1957,0,F,
214,Leandro Barbosa,2004,2017,13,G,
215,Steve Bardo,1992,1996,4,G,
216,J.J. Barea,2007,2020,13,G,
217,Andrea Bargnani,2007,2016,9,F,C
218,Cliff Barker,1950,1952,2,G,
219,Tom Barker,1977,1979,2,C,F
220,Charles Barkley*,1985,2000,15,F,
221,Erick Barkley,2001,2002,1,G,
222,Don Barksdale*,1952,1955,3,F,C
223,Harrison Barnes,2013,2022,9,F,
224,Harry Barnes,1969,1969,0,F,
225,Jim Barnes,1965,1971,6,C,F
226,Marvin Barnes,1975,1980,5,F,C
227,Matt Barnes,2004,2017,13,F,
228,Scottie Barnes,2022,2022,0,G,F
229,Dick Barnett,1960,1974,14,G,F
230,Jim Barnett,1967,1977,10,G,F
231,Nathaniel Barnett,1976,1976,0,G,
232,John Barnhill,1963,1972,9,G,
233,Norton Barnhill,1977,1977,0,G,
234,Leo Barnhorst,1950,1954,4,F,G
235,John Barr,1947,1947,0,F,
236,Mike Barr,1973,1977,4,G,
237,Moe Barr,1971,1971,0,G,
238,Andre Barrett,2005,2008,3,G,
239,Ernie Barrett,1954,1956,2,G,F
240,Mike Barrett,1970,1973,3,G,
241,RJ Barrett,2020,2022,2,G,F
242,Earl Barron,2006,2015,9,C,
243,Dana Barros,1990,2004,14,G,
244,Brent Barry,1996,2009,13,G,
245,Drew Barry,1998,2000,2,G,
246,Jon Barry,1993,2006,13,G,
247,Rick Barry*,1966,1980,14,F,
248,Ed Bartels,1950,1951,1,F,
249,Vic Bartolome,1972,1972,0,C,
250,Will Barton,2013,2022,9,G,
251,Eddie Basden,2006,2006,0,G,
252,Jerry Baskerville,1976,1976,0,F,
253,Brandon Bass,2006,2017,11,F,
254,Paris Bass,2022,2022,0,F,
255,Tim Bassett,1974,1980,6,F,C
256,Charles Bassey,2022,2022,0,C,
257,Maceo Baston,2003,2009,6,F,
258,Mengke Bateer,2002,2004,2,C,
259,Billy Ray Bates,1980,1983,3,G,
260,Keita Bates-Diop,2019,2022,3,F,
261,Esteban Batista,2006,2007,1,F,C
262,Mike Batiste,2003,2003,0,F,
263,Tony Battie,1998,2012,14,C,F
264,Shane Battier,2002,2014,12,F,
265,John Battle,1986,1995,9,G,
266,Kenny Battle,1990,1993,3,F,
267,Dave Batton,1983,1984,1,C,
268,Lloyd Batts,1975,1975,0,G,F
269,Nicolas Batum,2009,2022,13,F,G
270,Johnny Baum,1970,1974,4,F,
271,Frankie Baumholtz,1947,1947,0,G,
272,Lonny Baxter,2003,2006,3,F,
273,Jerryd Bayless,2009,2019,10,G,
274,Elgin Baylor*,1959,1972,13,F,
275,Howard Bayne,1968,1968,0,F,
276,Aron Baynes,2013,2021,8,C,
277,Sergei Bazarevich,1995,1995,0,G,
278,Kent Bazemore,2013,2022,9,G,F
279,Darius Bazley,2020,2022,2,F,
280,Ed Beach,1951,1951,0,F,
281,Bradley Beal,2013,2022,9,G,
282,Al Beard,1968,1968,0,C,
283,Butch Beard,1970,1979,9,G,
284,Ralph Beard,1950,1951,1,G,
285,Charles Beasley,1968,1971,3,G,F
286,Jerome Beasley,2004,2004,0,F,
287,John Beasley,1968,1974,6,F,C
288,Malik Beasley,2017,2022,5,G,
289,Michael Beasley,2009,2019,10,F,
290,Zelmo Beaty*,1963,1975,12,C,
291,Rodrigue Beaubois,2010,2013,3,G,
292,Byron Beck,1968,1977,9,C,F
293,Corey Beck,1996,1999,3,G,
294,Ernie Beck,1954,1961,7,G,F
295,Arthur Becker,1968,1973,5,F,
296,Moe Becker,1947,1947,0,G,F
297,Bob Bedell,1968,1971,3,F,
298,William Bedford,1987,1993,6,C,
299,Hank Beenders,1947,1949,2,C,F
300,Ron Behagen,1974,1980,6,F,C
301,Elmer Behnke,1952,1952,0,C,
302,Marco Belinelli,2008,2020,12,G,F
303,Charlie Bell,2002,2011,9,G,
304,Dennis Bell,1974,1976,2,F,
305,Jordan Bell,2018,2022,4,F,
306,Raja Bell,2001,2012,11,G,
307,Troy Bell,2004,2004,0,G,
308,Whitey Bell,1960,1961,1,G,
309,Walt Bellamy*,1962,1975,13,C,
310,DeAndre' Bembry,2017,2022,5,F,
311,Irv Bemoras,1954,1957,3,F,G
312,Leon Benbow,1975,1976,1,G,
313,Dragan Bender,2017,2020,3,F,
314,Jonathan Bender,2000,2010,10,F,
315,Jerrelle Benimon,2015,2015,0,F,
316,Benoit Benjamin,1986,2000,14,C,
317,Corey Benjamin,1999,2003,4,G,
318,Anthony Bennett,2014,2017,3,F,
319,Elmer Bennett,1995,1997,2,G,
320,Mario Bennett,1996,2000,4,F,
321,Mel Bennett,1976,1982,6,F,
322,Spider Bennett,1969,1969,0,G,
323,Tony Bennett,1993,1995,2,G,
324,Winston Bennett,1990,1992,2,F,
325,David Benoit,1992,2001,9,F,
326,Keith Benson,2012,2012,0,C,
327,Kent Benson,1978,1988,10,C,
328,Ben Bentil,2017,2017,0,F,
329,Gene Berce,1950,1950,0,G,F
330,Gary Bergen,1957,1957,0,C,
331,Larry Bergh,1970,1970,0,F,
332,Ricky Berry,1989,1989,0,F,
333,Walter Berry,1987,1989,2,F,
334,Dairis Bertāns,2019,2019,0,G,
335,Dāvis Bertāns,2017,2022,5,F,
336,Del Beshore,1979,1980,1,G,
337,Travis Best,1996,2005,9,G,
338,Patrick Beverley,2013,2022,9,G,
339,Saddiq Bey,2021,2022,1,F,
340,Tyler Bey,2021,2021,0,F,
341,Sim Bhullar,2015,2015,0,C,
342,Wesley Bialosuknia,1968,1968,0,G,
343,Al Bianchi,1957,1966,9,G,
344,Hank Biasatti,1947,1947,0,G,
345,Henry Bibby,1973,1981,8,G,
346,Mike Bibby,1999,2012,13,G,
347,Ed Biedenbach,1969,1969,0,G,
348,Andris Biedriņš,2005,2014,9,C,
349,Don Bielke,1956,1956,0,C,
350,Bob Bigelow,1976,1979,3,F,G
351,Lionel Billingy,1975,1975,0,F,C
352,Chauncey Billups,1998,2014,16,G,
353,Dave Bing*,1967,1978,11,G,
354,Joe Binion,1987,1987,0,F,
355,Khem Birch,2018,2022,4,C,F
356,Jabari Bird,2018,2018,0,G,
357,Jerry Bird,1959,1959,0,F,
358,Larry Bird*,1980,1992,12,F,
359,Otis Birdsong,1978,1989,11,G,
360,Gale Bishop,1949,1949,0,F,
361,Goga Bitadze,2020,2022,2,C,
362,Bismack Biyombo,2012,2022,10,C,F
363,Nemanja Bjelica,2016,2022,6,F,
364,Uwe Blab,1986,1990,4,C,
365,Charlie Black,1949,1952,3,F,C
366,Norman Black,1981,1981,0,G,
367,Tarik Black,2015,2018,3,C,F
368,Tom Black,1971,1971,0,C,
369,Rolando Blackman,1982,1994,12,G,
370,Alex Blackwell,1993,1993,0,F,
371,Cory Blackwell,1985,1985,0,F,
372,James Blackwell,1995,1995,0,G,
373,Nate Blackwell,1988,1988,0,G,
374,DeJuan Blair,2010,2016,6,F,C
375,Steve Blake,2004,2016,12,G,
376,Antonio Blakeney,2018,2019,1,G,
377,Will Blalock,2007,2007,0,G,
378,George Blaney,1962,1962,0,G,
379,Lance Blanks,1991,1993,2,G,
380,Ricky Blanton,1993,1993,0,F,
381,Andray Blatche,2006,2014,8,F,
382,Mookie Blaylock,1990,2002,12,G,
383,Eric Bledsoe,2011,2022,11,G,
384,Keljin Blevins,2021,2022,1,F,
385,Leon Blevins,1951,1951,0,G,
386,John Block,1967,1976,9,F,C
387,Mike Bloom,1948,1949,1,F,C
388,Jaron Blossomgame,2019,2019,0,F,
389,Corie Blount,1994,2004,10,F,
390,Mark Blount,2001,2009,8,C,
391,Vander Blue,2014,2018,4,G,
392,Ray Blume,1982,1982,0,G,
393,Nelson Bobb,1950,1953,3,G,
394,Tony Bobbitt,2005,2005,0,G,
395,Bucky Bockhorn,1959,1965,6,G,
396,Tom Boerwinkle,1969,1978,9,C,
397,Keith Bogans,2004,2014,10,G,F
398,Bogdan Bogdanović,2018,2022,4,G,
399,Bojan Bogdanović,2015,2022,7,G,F
400,Muggsy Bogues,1988,2001,13,G,
401,Andrew Bogut,2006,2019,13,C,
402,Etdrick Bohannon,1998,2001,3,F,
403,Bol Bol,2020,2022,2,F,C
404,Manute Bol,1986,1995,9,C,
405,Jonah Bolden,2019,2020,1,F,
406,Marques Bolden,2020,2021,1,C,
407,Bill Bolger,1954,1954,0,F,
408,Leandro Bolmaro,2022,2022,0,F,
409,Joel Bolomboy,2017,2018,1,F,
410,Doug Bolstorff,1958,1958,0,G,
411,George Bon Salle,1962,1962,0,F,
412,Phil Bond,1978,1978,0,G,
413,Walter Bond,1993,1995,2,G,
414,Jordan Bone,2020,2021,1,G,
415,Dexter Boney,1997,1997,0,G,
416,Isaac Bonga,2019,2022,3,G,
417,Ron Bonham,1965,1968,3,F,
418,Anthony Bonner,1991,1996,5,F,
419,Matt Bonner,2005,2016,11,F,
420,Butch Booker,1970,1970,0,C,
421,Devin Booker,2016,2022,6,G,
422,Melvin Booker,1996,1997,1,G,
423,Trevor Booker,2011,2018,7,F,
424,Josh Boone,2007,2010,3,F,C
425,Ron Boone,1969,1981,12,G,F
426,Calvin Booth,2000,2009,9,C,
427,Keith Booth,1998,1999,1,F,
428,Bob Boozer,1961,1971,10,F,
429,Carlos Boozer,2003,2015,12,F,C
430,Curtis Borchardt,2004,2005,1,C,
431,Jake Bornheimer,1949,1950,1,F,C
432,Lazaro Borrell,2000,2000,0,F,
433,Ike Borsavage,1951,1951,0,C,F
434,Vince Boryla,1950,1954,4,F,
435,Chris Bosh*,2004,2016,12,F,C
436,Jim Bostic,1978,1978,0,F,
437,Brandon Boston Jr.,2022,2022,0,G,F
438,Lawrence Boston,1980,1980,0,F,
439,Tom Boswell,1976,1984,8,F,C
440,Chris Boucher,2018,2022,4,F,
441,James Bouknight,2022,2022,0,G,
442,Ruben Boumtje-Boumtje,2002,2004,2,C,
443,Don Boven,1950,1953,3,F,G
444,Cal Bowdler,2000,2002,2,F,
445,Brian Bowen,2020,2021,1,F,
446,Bruce Bowen,1997,2009,12,F,
447,Ryan Bowen,2000,2010,10,F,
448,Tommie Bowens,1968,1970,2,F,C
449,Anthony Bowie,1989,1998,9,G,F
450,Sam Bowie,1985,1995,10,C,F
451,Orbie Bowling,1968,1968,0,C,
452,Ira Bowman,2000,2002,2,G,
453,Ky Bowman,2020,2020,0,G,
454,Nate Bowman,1967,1972,5,C,
455,Donnie Boyce,1996,1997,1,G,
456,Dennis Boyd,1979,1979,0,G,
457,Freddie Boyd,1973,1978,5,G,
458,Ken Boyd,1975,1975,0,F,
459,Earl Boykins,1999,2012,13,G,
460,Harry Boykoff,1950,1951,1,C,
461,Winford Boynes,1979,1981,2,G,F
462,Cedric Bozeman,2007,2007,0,G,
463,Steve Bracey,1973,1975,2,G,
464,Craig Brackins,2011,2012,1,F,
465,Gary Bradds,1965,1971,6,F,
466,Alex Bradley,1982,1982,0,F,
467,Alonzo Bradley,1978,1980,2,F,
468,Avery Bradley,2011,2022,11,G,
469,Bill Bradley,1968,1968,0,G,
470,Bill Bradley*,1968,1977,9,F,G
471,Charles Bradley,1982,1984,2,G,
472,Dudley Bradley,1980,1989,9,G,F
473,Jim Bradley,1974,1976,2,F,
474,Joe Bradley,1950,1950,0,G,
475,Michael Bradley,2002,2006,4,F,C
476,Shawn Bradley,1994,2005,11,C,
477,Tony Bradley,2018,2022,4,F,C
478,Mark Bradtke,1997,1997,0,C,F
479,Marques Bragg,1996,1996,0,F,
480,Torraye Braggs,2004,2005,1,F,
481,A.J. Bramlett,2000,2000,0,C,
482,Adrian Branch,1987,1990,3,F,G
483,Elton Brand,2000,2016,16,F,C
484,Terrell Brandon,1992,2002,10,G,
485,Bob Brannum,1950,1955,5,F,C
486,Brad Branson,1982,1983,1,C,F
487,Jesse Branson,1966,1968,2,F,
488,Jarrell Brantley,2020,2021,1,F,
489,Jim Brasco,1953,1953,0,G,
490,Mike Bratz,1978,1986,8,G,
491,Carl Braun*,1948,1962,14,G,F
492,Ignas Brazdeikis,2020,2022,2,F,
493,Tim Breaux,1995,1998,3,F,
494,J.R. Bremer,2003,2004,1,G,
495,Pete Brennan,1959,1959,0,F,
496,Tom Brennan,1955,1955,0,F,
497,Randy Breuer,1984,1994,10,C,
498,Corey Brewer,2008,2020,12,F,G
499,Jamison Brewer,2002,2005,3,G,
500,Jim Brewer,1974,1982,8,F,C
501,Ron Brewer,1979,1986,7,G,
502,Ronnie Brewer,2007,2014,7,G,F
503,Primož Brezec,2002,2010,8,C,
504,Frankie Brian,1950,1956,6,G,
505,Frank Brickowski,1985,1997,12,F,C
506,Junior Bridgeman,1976,1987,11,F,G
507,Bill Bridges,1963,1975,12,F,C
508,Mikal Bridges,2019,2022,3,G,
509,Miles Bridges,2019,2022,3,G,F
510,Al Brightman,1947,1947,0,F,
511,Amida Brimah,2021,2021,0,C,
512,Aud Brindley,1947,1947,0,F,
513,Isaiah Briscoe,2019,2019,0,G,
514,John Brisker,1970,1975,5,F,G
515,Oshae Brissett,2020,2022,2,F,
516,Allan Bristow,1974,1983,9,F,G
517,Tyrone Britt,1968,1968,0,G,
518,Wayman Britt,1978,1978,0,G,
519,Mike Brittain,1986,1987,1,C,
520,Dave Britton,1981,1981,0,G,
521,Jon Brockman,2010,2012,2,F,
522,Ryan Broekhoff,2019,2020,1,F,
523,Jim Brogan,1982,1983,1,G,
524,Malcolm Brogdon,2017,2022,5,G,
525,Gary Brokaw,1975,1978,3,G,
526,Price Brookfield,1949,1950,1,F,G
527,Clarence Brookins,1971,1971,0,F,
528,Aaron Brooks,2008,2018,10,G,
529,Armoni Brooks,2021,2022,1,G,
530,Dillon Brooks,2018,2022,4,F,G
531,Kevin Brooks,1992,1994,2,F,
532,MarShon Brooks,2012,2019,7,G,F
533,Michael Brooks,1981,1988,7,F,
534,Scott Brooks,1989,1998,9,G,
535,Andre Brown,2007,2009,2,F,
536,Anthony Brown,2016,2018,2,F,G
537,Bob Brown,1949,1950,1,F,
538,Bobby Brown,2009,2018,9,G,
539,Bruce Brown,2019,2022,3,G,
540,Charlie Brown Jr.,2020,2022,2,G,
541,Chaundee Brown Jr.,2022,2022,0,G,F
542,Chucky Brown,1990,2002,12,F,
543,Damone Brown,2002,2005,3,F,
544,Darrel Brown,1949,1949,0,F,
545,Dee Brown,1991,2002,11,G,
546,Dee Brown,2007,2009,2,G,
547,Derrick Brown,2010,2012,2,F,
548,Devin Brown,2003,2010,7,G,
549,Ernest Brown,2002,2002,0,C,
550,Fred Brown,1972,1984,12,G,
551,George Brown,1958,1958,0,F,
552,Gerald Brown,1999,1999,0,G,
553,Greg Brown III,2022,2022,0,F,
554,Harold Brown,1947,1947,0,G,
555,Jabari Brown,2015,2015,0,G,
556,Jaylen Brown,2017,2022,5,F,G
557,John Brown,1974,1980,6,F,
558,Kedrick Brown,2002,2005,3,G,
559,Kwame Brown,2002,2013,11,F,
560,Larry Brown*,1968,1972,4,G,
561,Leon Brown,1947,1947,0,F,
562,Lewis Brown,1981,1981,0,C,
563,Lorenzo Brown,2014,2019,5,G,
564,Marcus Brown,1997,2000,3,G,
565,Markel Brown,2015,2018,3,G,
566,Mike Brown,1987,1997,10,C,F
567,Moses Brown,2020,2022,2,C,
568,Myron Brown,1992,1992,0,G,
569,P.J. Brown,1994,2008,14,F,C
570,Randy Brown,1992,2003,11,G,
571,Raymond Brown,1990,1990,0,F,
572,Rickey Brown,1981,1985,4,C,F
573,Roger Brown*,1968,1975,7,F,G
574,Roger Brown,1973,1980,7,C,
575,Shannon Brown,2007,2015,8,G,
576,Stan Brown,1948,1952,4,F,
577,Sterling Brown,2018,2022,4,G,
578,Tierre Brown,2002,2005,3,G,
579,Tony Brown,1985,1992,7,F,G
580,Troy Brown Jr.,2019,2022,3,G,F
581,Jim Browne,1949,1950,1,C,
582,Stanley Brundy,1990,1990,0,F,
583,Brian Brunkhorst,1969,1969,0,F,
584,George Bruns,1973,1973,0,G,
585,Jalen Brunson,2019,2022,3,G,
586,Rick Brunson,1998,2006,8,G,
587,Nicolás Brussino,2017,2018,1,G,F
588,Elijah Bryant,2021,2021,0,G,
589,Em Bryant,1965,1972,7,G,
590,Joe Bryant,1976,1983,7,F,C
591,Kobe Bryant*,1997,2016,19,G,F
592,Mark Bryant,1989,2003,14,F,C
593,Thomas Bryant,2018,2022,4,C,
594,Wallace Bryant,1984,1986,2,C,
595,Torgeir Bryn,1990,1990,0,C,
596,George Bucci,1976,1976,0,G,
597,Shaq Buchanan,2022,2022,0,G,
598,Joe Buckhalter,1962,1963,1,F,
599,Steve Bucknall,1990,1990,0,G,
600,Cleveland Buckner,1962,1963,1,F,C
601,Greg Buckner,2000,2009,9,G,
602,Quinn Buckner,1977,1986,9,G,
603,Dave Budd,1961,1965,4,F,
604,Chase Budinger,2010,2016,6,F,
605,Walt Budko,1949,1952,3,F,C
606,Jud Buechler,1991,2002,11,F,G
607,Rodney Buford,2000,2005,5,G,F
608,Matt Bullard,1991,2002,11,F,
609,Reggie Bullock,2014,2022,8,G,F
610,Larry Bunce,1968,1969,1,C,
611,Greg Bunch,1979,1979,0,F,
612,Dick Bunt,1953,1953,0,G,
613,Bill Buntin,1966,1966,0,C,F
614,Bill Bunting,1970,1972,2,F,C
615,Ticky Burden,1976,1978,2,G,
616,Pat Burke,2003,2007,4,C,F
617,Trey Burke,2014,2022,8,G,
618,Roger Burkman,1982,1982,0,G,
619,Alec Burks,2012,2022,10,G,
620,Antonio Burks,2005,2006,1,G,
621,Kevin Burleson,2006,2006,0,G,
622,Tom Burleson,1975,1981,6,C,
623,Jack Burmaster,1950,1950,0,G,
624,David Burns,1982,1982,0,G,
625,Evers Burns,1994,1994,0,F,
626,Jim Burns,1968,1968,0,G,
627,Scott Burrell,1994,2001,7,G,F
628,Art Burris,1951,1952,1,F,
629,Junior Burrough,1996,1996,0,F,
630,Bob Burrow,1957,1958,1,C,F
631,Deonte Burton,2019,2020,1,G,
632,Ed Burton,1962,1965,3,F,
633,Willie Burton,1991,1999,8,F,G
634,Steve Burtt,1985,1993,8,G,
635,Don Buse,1973,1985,12,G,
636,David Bustion,1973,1973,0,F,
637,Donnie Butcher,1962,1966,4,G,
638,Al Butler,1962,1965,3,G,
639,Caron Butler,2003,2016,13,F,
640,Greg Butler,1989,1991,2,C,
641,Jackie Butler,2005,2007,2,F,C
642,Jared Butler,2022,2022,0,G,
643,Jimmy Butler,2012,2022,10,F,G
644,Mike Butler,1969,1972,3,G,
645,Mitchell Butler,1994,2004,10,G,F
646,Rasual Butler,2003,2016,13,F,G
647,Dwight Buycks,2014,2018,4,G,
648,Derrick Byars,2012,2012,0,F,
649,Andrew Bynum,2006,2014,8,C,
650,Will Bynum,2006,2015,9,G,
651,Walter Byrd,1970,1970,0,F,
652,Marty Byrnes,1979,1983,4,F,
653,Tommy Byrnes,1947,1951,4,F,G
654,Michael Bytzura,1947,1947,0,F,
655,Žarko Čabarkapa,2004,2006,2,F,
656,Barney Cable,1959,1964,5,F,
657,Bruno Caboclo,2015,2021,6,F,C
658,Devontae Cacok,2020,2022,2,F,
659,Jason Caffey,1996,2003,7,F,
660,Michael Cage,1985,2000,15,F,C
661,Gerry Calabrese,1951,1952,1,G,
662,Nick Calathes,2014,2015,1,G,
663,José Calderón,2006,2019,13,G,
664,Adrian Caldwell,1990,1998,8,F,C
665,Jim Caldwell,1968,1969,1,C,
666,Joe Caldwell,1965,1975,10,F,G
667,Kentavious Caldwell-Pope,2014,2022,8,G,
668,Bill Calhoun,1949,1955,6,F,G
669,Corky Calhoun,1973,1980,7,F,
670,Demetrius Calip,1992,1992,0,G,
671,Tom Callahan,1947,1947,0,G,
672,Rick Calloway,1991,1991,0,F,
673,Ernie Calverley,1947,1949,2,G,
674,Mack Calvin,1970,1981,11,G,
675,Dexter Cambridge,1993,1993,0,F,
676,Marcus Camby,1997,2013,16,C,F
677,Facundo Campazzo,2021,2022,1,G,
678,Elden Campbell,1991,2005,14,C,
679,Tony Campbell,1985,1995,10,F,G
680,Isaiah Canaan,2014,2019,5,G,
681,Vlatko Čančar,2020,2022,2,F,
682,Devin Cannady,2021,2021,0,G,
683,Larry Cannon,1970,1974,4,G,
684,Clint Capela,2015,2022,7,C,
685,Derrick Caracter,2011,2011,0,F,
686,Frank Card,1969,1973,4,F,
687,Brian Cardinal,2001,2012,11,F,
688,Vernon Carey Jr.,2021,2022,1,C,
689,Howie Carl,1962,1962,0,G,
690,Chet Carlisle,1947,1947,0,F,C
691,Geno Carlisle,2005,2005,0,G,
692,Rick Carlisle,1985,1990,5,G,
693,Don Carlos,1969,1969,0,G,F
694,Al Carlson,1976,1976,0,C,
695,Don Carlson,1947,1951,4,G,F
696,Bob Carney,1955,1955,0,G,
697,Rodney Carney,2007,2011,4,F,
698,Bob Carpenter,1950,1951,1,F,C
699,Antoine Carr,1985,2000,15,F,C
700,Austin Carr,1972,1981,9,G,
701,Chris Carr,1996,2001,5,G,
702,Cory Carr,1999,1999,0,G,
703,Kenny Carr,1978,1987,9,F,
704,M.L. Carr,1976,1985,9,F,G
705,Darel Carrier,1968,1973,5,G,
706,Bob Carrington,1978,1980,2,G,F
707,DeMarre Carroll,2010,2020,10,F,
708,Joe Barry Carroll,1981,1991,10,C,F
709,Matt Carroll,2004,2013,9,G,
710,Jimmy Carruth,1997,1997,0,C,F
711,Anthony Carter,2000,2012,12,G,
712,Butch Carter,1981,1986,5,G,
713,Fred Carter,1970,1977,7,G,F
714,George Carter,1968,1976,8,F,G
715,Howard Carter,1984,1985,1,G,
716,Jake Carter,1950,1950,0,F,C
717,Jevon Carter,2019,2022,3,G,
718,Maurice Carter,2004,2004,0,G,
719,Reggie Carter,1981,1982,1,G,
720,Ron Carter,1979,1980,1,G,
721,Vince Carter,1999,2020,21,G,F
722,Wendell Carter Jr.,2019,2022,3,C,
723,Michael Carter-Williams,2014,2021,7,G,
724,Bill Cartwright,1980,1995,15,C,
725,Jay Carty,1969,1969,0,F,
726,Alex Caruso,2018,2022,4,G,
727,Cornelius Cash,1977,1977,0,F,
728,Sam Cash,1973,1973,0,F,
729,Sam Cassell,1994,2008,14,G,
730,Omri Casspi,2010,2019,9,F,
731,Harvey Catchings,1975,1985,10,C,F
732,Terry Catledge,1986,1993,7,F,
733,Sid Catlett,1972,1972,0,F,
734,Kelvin Cato,1998,2007,9,C,
735,Bobby Cattage,1982,1986,4,F,
736,Willie Cauley-Stein,2016,2022,6,F,C
737,Troy Caupain,2019,2019,0,G,
738,Duane Causwell,1991,2001,10,C,
739,Tyler Cavanaugh,2018,2019,1,F,
740,Ron Cavenall,1985,1989,4,C,
741,Ahmad Caver,2022,2022,0,G,
742,Cedric Ceballos,1991,2001,10,F,
743,John Celestand,2000,2000,0,G,
744,Al Cervi*,1950,1953,3,G,F
745,Lionel Chalmers,2005,2005,0,G,
746,Mario Chalmers,2009,2018,9,G,
747,Bill Chamberlain,1973,1974,1,F,
748,Wilt Chamberlain*,1960,1973,13,C,
749,Jerry Chambers,1967,1974,7,F,
750,Tom Chambers,1982,1998,16,F,C
751,Justin Champagnie,2022,2022,0,F,
752,Mike Champion,1989,1989,0,F,
753,Tyson Chandler,2002,2020,18,C,
754,Wilson Chandler,2008,2020,12,F,
755,Don Chaney,1969,1980,11,G,
756,John Chaney,1950,1950,0,F,C
757,Rex Chapman,1989,2000,11,G,
758,Wayne Chapman,1969,1972,3,G,F
759,Len Chappell,1963,1972,9,F,C
760,Ken Charles,1974,1978,4,G,
761,Lorenzo Charles,1986,1986,0,F,
762,Joe Chealey,2019,2020,1,G,
763,Calbert Cheaney,1994,2006,12,G,F
764,Zylan Cheatham,2020,2022,2,F,
765,Maurice Cheeks*,1979,1993,14,G,
766,Phil Chenier,1972,1981,9,G,
767,Will Cherry,2015,2015,0,G,
768,Derrick Chievous,1989,1991,2,F,
769,Pete Chilcutt,1992,2000,8,F,C
770,Josh Childress,2005,2014,9,G,F
771,Randolph Childress,1996,1997,1,G,
772,Chris Childs,1995,2003,8,G,
773,Chris Chiozza,2019,2022,3,G,
774,Leroy Chollet,1950,1951,1,F,
775,Jim Chones,1973,1982,9,C,F
776,Marquese Chriss,2017,2022,5,F,
777,Fred Christ,1955,1955,0,G,
778,Cal Christensen,1951,1955,4,F,C
779,Bob Christian,1970,1974,4,C,
780,Doug Christie,1993,2007,14,G,F
781,Dionte Christmas,2014,2014,0,G,
782,Rakeem Christmas,2016,2017,1,F,
783,Semaj Christon,2017,2017,0,G,
784,Josh Christopher,2022,2022,0,G,
785,Patrick Christopher,2015,2015,0,G,F
786,Stephen Chubin,1968,1970,2,G,
787,Robert Churchwell,1996,1996,0,G,F
788,Archie Clark,1967,1976,9,G,
789,Carlos Clark,1984,1985,1,G,
790,Earl Clark,2010,2015,5,F,
791,Gary Clark,2019,2022,3,F,
792,Ian Clark,2014,2019,5,G,
793,Keon Clark,1999,2004,5,F,C
794,Richard Clark,1968,1969,1,G,
795,Brandon Clarke,2020,2022,2,F,
796,Coty Clarke,2016,2016,0,F,
797,Jordan Clarkson,2015,2022,7,G,
798,Gian Clavell,2018,2018,0,G,
799,Victor Claver,2013,2015,2,F,
800,John Clawson,1969,1969,0,F,
801,Charles Claxton,1996,1996,0,C,
802,Nic Claxton,2020,2022,2,F,
803,Speedy Claxton,2002,2009,7,G,
804,Jim Cleamons,1972,1980,8,G,
805,Mateen Cleaves,2001,2006,5,G,
806,Barry Clemens,1966,1976,10,F,
807,Chris Clemons,2020,2020,0,G,
808,Antonius Cleveland,2018,2020,2,G,
809,Nat Clifton*,1951,1958,7,C,F
810,Bill Closs,1950,1952,2,F,C
811,Keith Closs,1998,2000,2,C,
812,Paul Cloyd,1950,1950,0,G,F
813,Bob Cluggish,1947,1947,0,C,
814,Ben Clyde,1975,1975,0,F,
815,Amir Coffey,2020,2022,2,G,
816,Richard Coffey,1991,1991,0,F,
817,Fred Cofield,1986,1987,1,G,
818,John Coker,1996,2001,5,C,
819,Norris Cole,2012,2017,5,G,
820,Ben Coleman,1987,1994,7,F,
821,Derrick Coleman,1991,2005,14,F,C
822,E.C. Coleman,1974,1979,5,F,
823,Jack Coleman,1950,1958,8,F,C
824,Norris Coleman,1988,1988,0,F,
825,Bimbo Coles,1991,2004,13,G,
826,Jason Collier,2001,2005,4,C,
827,Art Collins,1981,1981,0,G,
828,Don Collins,1981,1987,6,F,G
829,Doug Collins,1974,1981,7,G,F
830,James Collins,1998,1998,0,G,
831,Jarron Collins,2002,2011,9,F,C
832,Jason Collins,2002,2014,12,C,
833,Jimmy Collins,1971,1972,1,G,
834,John Collins,2018,2022,4,F,
835,Mardy Collins,2007,2010,3,G,
836,Sherron Collins,2011,2011,0,G,
837,Zach Collins,2018,2022,4,C,F
838,Kyle Collinsworth,2018,2018,0,G,F
839,Darren Collison,2010,2022,12,G,
840,Nick Collison,2005,2018,13,F,
841,Joe Colone,1949,1949,0,F,
842,Bonzie Colson,2019,2019,0,F,
843,Sean Colson,2001,2001,0,G,
844,Steve Colter,1985,1995,10,G,
845,Glen Combs,1969,1975,6,G,
846,Leroy Combs,1984,1984,0,F,
847,John Comeaux,1968,1968,0,F,
848,Dallas Comegys,1988,1989,1,F,
849,Larry Comley,1964,1964,0,G,
850,Jeffrey Congdon,1968,1972,4,G,
851,Gene Conley,1953,1964,11,C,F
852,Larry Conley,1968,1968,0,G,
853,Mike Conley,2008,2022,14,G,
854,Ed Conlin,1956,1962,6,F,G
855,Marty Conlon,1992,2000,8,F,C
856,Pat Connaughton,2016,2022,6,G,
857,Jimmy Conner,1976,1976,0,G,
858,Lester Conner,1983,1995,12,G,
859,Chuck Connors,1947,1948,1,F,C
860,Will Conroy,2007,2013,6,G,
861,Anthony Cook,1991,1996,5,F,C
862,Bert Cook,1955,1955,0,G,F
863,Bobby Cook,1950,1950,0,G,F
864,Brian Cook,2004,2012,8,F,
865,Daequan Cook,2008,2013,5,G,
866,Darwin Cook,1981,1989,8,G,
867,Jeff Cook,1980,1988,8,F,C
868,Norm Cook,1977,1978,1,F,
869,Omar Cook,2004,2005,1,G,
870,Quinn Cook,2017,2021,4,G,
871,Tyler Cook,2020,2022,2,F,
872,Charles Cooke,2018,2018,0,G,
873,David Cooke,1986,1986,0,F,
874,Joe Cooke,1971,1971,0,G,
875,Jack Cooley,2015,2018,3,F,C
876,Chuck Cooper*,1951,1956,5,F,
877,Duane Cooper,1993,1994,1,G,
878,Joe Cooper,1982,1985,3,C,F
879,Michael Cooper,1979,1990,11,G,F
880,Sharife Cooper,2022,2022,0,G,
881,Wayne Cooper,1979,1992,13,C,F
882,Tom Copa,1992,1992,0,C,
883,Chris Copeland,2013,2016,3,F,
884,Hollis Copeland,1980,1982,2,F,
885,Lanard Copeland,1990,1992,2,G,
886,Tyrone Corbin,1986,2001,15,G,F
887,Chris Corchiani,1992,1994,2,G,
888,Ken Corley,1947,1947,0,C,
889,Ray Corley,1950,1953,3,G,
890,Petr Cornelie,2022,2022,0,F,
891,Dave Corzine,1979,1991,12,C,
892,Larry Costello,1955,1968,13,G,
893,Matt Costello,2018,2018,0,F,
894,Bryce Cotton,2015,2016,1,G,
895,Jack Cotton,1950,1950,0,F,C
896,James Cotton,1998,1999,1,G,
897,John Coughran,1980,1980,0,F,
898,Mel Counts,1965,1976,11,C,F
899,Steve Courtin,1965,1965,0,G,
900,Joe Courtney,1993,1997,4,F,
901,Marcus Cousin,2011,2011,0,C,
902,DeMarcus Cousins,2011,2022,11,C,F
903,Bob Cousy*,1951,1970,19,G,
904,Robert Covington,2014,2022,8,F,C
905,Dave Cowens*,1971,1983,12,C,F
906,Chubby Cox,1983,1983,0,G,
907,Johnny Cox,1963,1963,0,G,
908,Wesley Cox,1978,1979,1,F,
909,Allen Crabbe,2014,2020,6,G,F
910,Torrey Craig,2018,2022,4,G,F
911,Chris Crawford,1998,2004,6,F,
912,Freddie Crawford,1967,1971,4,G,F
913,Jamal Crawford,2001,2020,19,G,
914,Joe Crawford,2009,2009,0,F,
915,Jordan Crawford,2011,2018,7,G,
916,Mitch Creek,2019,2019,0,G,
917,Jim Creighton,1976,1976,0,F,
918,Ron Crevier,1986,1986,0,C,
919,Hal Crisler,1947,1947,0,F,
920,Joe Crispin,2002,2002,0,G,
921,Charlie Criss,1978,1985,7,G,
922,Russell Critchfield,1969,1969,0,G,
923,Winston Crite,1988,1989,1,F,
924,Javaris Crittenton,2008,2009,1,G,
925,Dillard Crocker,1949,1953,4,F,G
926,Bobby Croft,1971,1971,0,C,
927,Geoff Crompton,1979,1984,5,C,
928,Terry Crosby,1980,1980,0,G,
929,Austin Croshere,1998,2009,11,F,
930,Jeff Cross,1986,1986,0,F,
931,Pete Cross,1971,1973,2,C,F
932,Russell Cross,1984,1984,0,C,
933,Chink Crossin,1948,1950,2,G,
934,John Crotty,1993,2003,10,G,
935,Bill Crow,1968,1968,0,G,
936,Mark Crow,1978,1978,0,F,
937,Corey Crowder,1992,1995,3,G,F
938,Jae Crowder,2013,2022,9,F,
939,Al Cueto,1970,1971,1,C,F
940,Jarrett Culver,2020,2022,2,G,
941,Jarron Cumberland,2022,2022,0,G,
942,Pat Cummings,1980,1991,11,F,C
943,Terry Cummings,1983,2000,17,F,
944,Vonteego Cummings,2000,2002,2,G,
945,Billy Cunningham*,1966,1976,10,F,C
946,Cade Cunningham,2022,2022,0,G,
947,Dante Cunningham,2010,2019,9,F,
948,Dick Cunningham,1969,1975,6,C,
949,Jared Cunningham,2013,2016,3,G,
950,William Cunningham,1998,1999,1,C,
951,Radisav Ćurčić,1993,1993,0,C,
952,Armand Cure,1947,1947,0,F,
953,Earl Cureton,1981,1997,16,F,C
954,Bill Curley,1995,2001,6,F,
955,Fran Curran,1949,1950,1,G,
956,Dell Curry,1987,2002,15,G,
957,Eddy Curry,2002,2013,11,C,
958,JamesOn Curry,2010,2010,0,G,
959,Michael Curry,1994,2005,11,F,G
960,Seth Curry,2014,2022,8,G,
961,Stephen Curry,2010,2022,12,G,
962,Rastko Cvetković,1996,1996,0,C,
963,Mike D'Antoni,1974,1977,3,G,
964,Mike Dabich,1968,1968,0,C,
965,Ed Dahler,1952,1952,0,F,
966,Quintin Dailey,1983,1992,9,G,
967,Samuel Dalembert,2002,2015,13,C,
968,Howie Dallmar,1947,1949,2,F,
969,Erick Dampier,1997,2012,15,C,
970,Louie Dampier*,1968,1979,11,G,
971,Bob Dandridge*,1970,1982,12,F,G
972,Antonio Daniels,1998,2011,13,G,
973,Erik Daniels,2005,2005,0,F,
974,Lloyd Daniels,1993,1998,5,G,
975,Marquis Daniels,2004,2013,9,G,F
976,Mel Daniels*,1968,1977,9,C,
977,Troy Daniels,2014,2020,6,G,
978,Sasha Danilović,1996,1997,1,G,
979,Adrian Dantley*,1977,1991,14,F,G
980,Pete Darcey,1953,1953,0,C,
981,Jimmy Darden,1950,1950,0,G,
982,Ollie Darden,1968,1970,2,F,C
983,Yinka Dare,1995,1998,3,C,
984,Jesse Dark,1975,1975,0,G,
985,Nate Darling,2021,2021,0,G,
986,Rick Darnell,1976,1976,0,C,F
987,Jimmy Darrow,1962,1962,0,G,
988,Gigi Datome,2014,2015,1,F,
989,Brad Daugherty,1987,1994,7,C,
990,Mack Daughtry,1971,1971,0,G,
991,Kornél Dávid,1999,2001,2,F,
992,Jermareo Davidson,2008,2009,1,F,
993,Bob Davies*,1949,1955,6,G,F
994,Brandon Davies,2014,2015,1,F,
995,Anthony Davis,2013,2022,9,F,C
996,Antonio Davis,1994,2006,12,F,C
997,Aubrey Davis,1947,1947,0,G,F
998,Baron Davis,2000,2012,12,G,
999,Ben Davis,1997,2000,3,F,
1000,Bill Davis,1947,1947,0,F,
1001,Bob Davis,1973,1973,0,F,
1002,Brad Davis,1978,1992,14,G,
1003,Brian Davis,1994,1994,0,F,G
1004,Charles Davis,1982,1990,8,F,
1005,Charlie Davis,1972,1974,2,G,
1006,Dale Davis,1992,2007,15,F,C
1007,Deyonta Davis,2017,2019,2,C,F
1008,Dwight Davis,1973,1977,4,F,
1009,Ed Davis,2011,2022,11,F,
1010,Emanual Davis,1997,2003,6,G,
1011,Glen Davis,2008,2015,7,F,C
1012,Harry Davis,1979,1980,1,F,
1013,Hubert Davis,1993,2004,11,G,
1014,Jim Davis,1968,1975,7,C,F
1015,Johnny Davis,1977,1986,9,G,
1016,Josh Davis,2004,2012,8,F,
1017,Lee Davis,1969,1976,7,C,F
1018,Mark Davis,1989,1989,0,F,G
1019,Mark Davis,1996,2000,4,G,F
1020,Mel Davis,1974,1977,3,F,
1021,Mickey Davis,1972,1977,5,F,G
1022,Mike Davis,1970,1973,3,G,
1023,Mike Davis,1983,1983,0,F,
1024,Monti Davis,1981,1981,0,F,
1025,Paul Davis,2007,2010,3,C,
1026,Ralph Davis,1961,1962,1,G,
1027,Red Davis,1956,1956,0,C,
1028,Ricky Davis,1999,2010,11,G,
1029,Ron Davis,1977,1982,5,G,F
1030,Terence Davis,2020,2022,2,G,
1031,Terry Davis,1990,2001,11,F,C
1032,Tyler Davis,2019,2019,0,C,
1033,Walt Davis,1954,1958,4,C,F
1034,Walter Davis,1978,1992,14,G,F
1035,Warren Davis,1968,1973,5,F,C
1036,Willie Davis,1971,1971,0,C,
1037,Andre Dawkins,2015,2015,0,G,
1038,Darryl Dawkins,1976,1989,13,C,
1039,Johnny Dawkins,1987,1995,8,G,
1040,Paul Dawkins,1980,1980,0,F,
1041,Branden Dawson,2016,2016,0,F,
1042,Eric Dawson,2012,2012,0,F,
1043,Jimmy Dawson,1968,1968,0,G,
1044,Tony Dawson,1991,1995,4,F,
1045,Todd Day,1993,2001,8,G,F
1046,Austin Daye,2010,2015,5,F,
1047,Darren Daye,1984,1988,4,F,G
1048,Nando De Colo,2013,2014,1,G,
1049,Billy DeAngelis,1971,1971,0,G,
1050,Dave DeBusschere*,1963,1974,11,F,G
1051,Andrew DeClercq,1996,2005,9,F,C
1052,Javin DeLaurier,2022,2022,0,F,
1053,Nate DeLong,1952,1952,0,C,
1054,Joe DePre,1971,1973,2,G,
1055,DeMar DeRozan,2010,2022,12,G,F
1056,Hank DeZonie,1951,1951,0,C,F
1057,Greg Deane,1980,1980,0,G,
1058,Gabriel Deck,2021,2022,1,F,
1059,Dewayne Dedmon,2014,2022,8,C,
1060,Don Dee,1969,1969,0,F,
1061,Archie Dees,1959,1962,3,F,C
1062,Terry Dehere,1994,1999,5,G,
1063,Red Dehnert,1947,1947,0,F,
1064,Bryce Dejean-Jones,2016,2016,0,G,
1065,Sam Dekker,2016,2022,6,F,
1066,Vinny Del Negro,1989,2002,13,G,
1067,Malcolm Delaney,2017,2018,1,G,
1068,Bison Dele,1992,1999,7,F,C
1069,Carlos Delfino,2005,2013,8,G,
1070,Ángel Delgado,2019,2019,0,C,
1071,Tony Delk,1997,2006,9,G,
1072,Matthew Dellavedova,2014,2021,7,G,
1073,Fennis Dembo,1989,1989,0,F,
1074,Larry Demic,1980,1982,2,F,C
1075,Dell Demps,1994,1997,3,G,
1076,George Dempsey,1955,1959,4,G,
1077,Luol Deng,2005,2019,14,F,
1078,Kenny Dennard,1982,1984,2,F,
1079,Blaine Denning,1953,1953,0,G,
1080,Justin Dentmon,2012,2013,1,G,
1081,Randy Denton,1972,1977,5,C,
1082,Rod Derline,1975,1976,1,G,
1083,Marcus Derrickson,2019,2019,0,F,
1084,Dave Deutsch,1967,1967,0,G,
1085,Corky Devlin,1956,1958,2,G,
1086,Ernie DiGregorio,1974,1978,4,G,
1087,Donte DiVincenzo,2019,2022,3,G,
1088,Mamadi Diakite,2021,2022,1,F,
1089,Derrick Dial,2000,2004,4,G,
1090,Cheick Diallo,2017,2022,5,F,
1091,Hamidou Diallo,2019,2022,3,G,
1092,Boris Diaw,2004,2017,13,F,C
1093,Yakhouba Diawara,2007,2010,3,G,F
1094,Guillermo Díaz,2008,2008,0,G,
1095,Dan Dickau,2003,2008,5,G,
1096,Kaniel Dickens,2004,2008,4,F,
1097,Henry Dickerson,1976,1977,1,G,
1098,Michael Dickerson,1999,2003,4,G,F
1099,Clyde Dickey,1975,1975,0,G,
1100,Derrek Dickey,1974,1978,4,F,
1101,Dick Dickey,1952,1952,0,G,
1102,John Dickson,1968,1968,0,C,
1103,Travis Diener,2006,2010,4,G,
1104,Gorgui Dieng,2014,2022,8,C,
1105,Connie Dierking,1959,1971,12,C,F
1106,Coby Dietrick,1971,1983,12,C,F
1107,Craig Dill,1968,1968,0,C,
1108,Dwaine Dillard,1976,1976,0,F,
1109,Mickey Dillard,1982,1982,0,G,
1110,Bob Dille,1947,1947,0,F,
1111,Hook Dillon,1950,1950,0,F,
1112,Byron Dinkins,1990,1991,1,G,
1113,Jackie Dinkins,1972,1972,0,F,
1114,Harry Dinnel,1968,1968,0,F,G
1115,Bill Dinwiddie,1968,1972,4,F,
1116,Spencer Dinwiddie,2015,2022,7,G,
1117,Ike Diogu,2006,2012,6,F,
1118,DeSagana Diop,2002,2013,11,C,
1119,Terry Dischinger,1963,1973,10,F,G
1120,Fred Diute,1955,1955,0,G,
1121,Vlade Divac*,1990,2005,15,C,
1122,Juan Dixon,2003,2009,6,G,
1123,Earl Dodd,1950,1950,0,F,
1124,Michael Doleac,1999,2008,9,C,
1125,Joe Dolhon,1950,1951,1,G,
1126,Bob Doll,1947,1950,3,F,C
1127,James Donaldson,1981,1995,14,C,
1128,Luka Dončić,2019,2022,3,G,F
1129,Bob Donham,1951,1954,3,G,F
1130,Billy Donovan,1988,1988,0,G,
1131,Harry Donovan,1950,1950,0,G,
1132,Keyon Dooling,2001,2013,12,G,
1133,Aleksandar Djordjevic,1997,1997,0,G,
1134,Jacky Dorsey,1978,1981,3,F,
1135,Joey Dorsey,2009,2015,6,F,
1136,Ron Dorsey,1972,1972,0,F,
1137,Tyler Dorsey,2018,2019,1,G,
1138,Luguentz Dort,2020,2022,2,G,
1139,Ayo Dosunmu,2022,2022,0,G,
1140,Damyean Dotson,2018,2022,4,G,
1141,Devon Dotson,2021,2022,1,G,
1142,Quincy Douby,2007,2009,2,G,
1143,Bruce Douglas,1987,1987,0,G,
1144,John Douglas,1982,1983,1,G,
1145,Leon Douglas,1977,1983,6,C,F
1146,Sherman Douglas,1990,2001,11,G,
1147,Toney Douglas,2010,2017,7,G,
1148,Chris Douglas-Roberts,2009,2015,6,G,
1149,Sekou Doumbouya,2020,2022,2,F,
1150,Sonny Dove,1968,1972,4,F,
1151,Jerry Dover,1972,1972,0,G,
1152,Zabian Dowdell,2011,2011,0,G,
1153,Bill Downey,1948,1948,0,C,
1154,Steve Downing,1974,1975,1,C,
1155,Jeff Dowtin,2022,2022,0,G,
1156,Danny Doyle,1963,1963,0,F,
1157,Milton Doyle,2018,2018,0,G,
1158,PJ Dozier,2018,2022,4,G,
1159,Terry Dozier,1990,1990,0,F,
1160,Goran Dragić,2009,2022,13,G,
1161,Zoran Dragić,2015,2015,0,G,F
1162,Greg Dreiling,1987,1997,10,C,
1163,Bryce Drew,1999,2004,5,G,
1164,John Drew,1975,1985,10,F,G
1165,Larry Drew,1981,1991,10,G,
1166,Larry Drew II,2015,2018,3,G,
1167,Clyde Drexler*,1984,1998,14,G,
1168,Nate Driggers,1997,1997,0,G,
1169,Terry Driscoll,1971,1975,4,F,
1170,Predrag Drobnjak,2002,2005,3,C,
1171,Ralph Drollinger,1981,1981,0,C,
1172,Andre Drummond,2013,2022,9,C,
1173,Dennis DuVal,1975,1976,1,G,
1174,Chris Duarte,2022,2022,0,G,
1175,Dick Duckett,1958,1958,0,G,
1176,Kevin Duckworth,1987,1997,10,C,
1177,Charles Dudley,1973,1979,6,G,
1178,Chris Dudley,1988,2003,15,C,
1179,Jared Dudley,2008,2021,13,F,G
1180,Terry Duerod,1980,1983,3,G,
1181,Bob Duffy,1947,1947,0,F,
1182,Bob Duffy,1963,1965,2,G,
1183,Chris Duhon,2005,2013,8,G,
1184,Duje Dukan,2016,2016,0,F,
1185,David Duke Jr.,2022,2022,0,G,
1186,Walter Dukes,1956,1963,7,C,
1187,Joe Dumars*,1986,1999,13,G,
1188,Rich Dumas,1969,1969,0,G,
1189,Richard Dumas,1993,1996,3,F,
1190,Tony Dumas,1995,1998,3,G,
1191,Andy Duncan,1949,1951,2,F,C
1192,Tim Duncan*,1998,2016,18,F,C
1193,Mike Dunleavy,1977,1990,13,G,
1194,Mike Dunleavy,2003,2017,14,F,G
1195,Kris Dunn,2017,2021,4,G,
1196,Pat Dunn,1958,1958,0,G,
1197,T.R. Dunn,1978,1991,13,G,F
1198,Ronald Dupree,2004,2011,7,F,
1199,Kevin Durant,2008,2022,14,F,G
1200,John Duren,1981,1983,2,G,
1201,Jarrett Durham,1972,1972,0,F,
1202,Pat Durham,1993,1995,2,F,
1203,Devin Durrant,1985,1986,1,F,
1204,Ken Durrett,1972,1975,3,F,
1205,Trevon Duval,2019,2019,0,G,
1206,Jack Dwan,1949,1949,0,F,G
1207,Craig Dykema,1982,1982,0,F,
1208,Gene Dyker,1954,1954,0,F,
1209,Jerome Dyson,2012,2012,0,G,
1210,Ledell Eackles,1989,1998,9,G,F
1211,Jim Eakins,1969,1978,9,C,
1212,Acie Earl,1994,1997,3,F,C
1213,Ed Earle,1954,1954,0,F,
1214,Cleanthony Early,2015,2016,1,F,
1215,Penny Early,1969,1969,0,G,
1216,Mark Eaton,1983,1993,10,C,
1217,Jerry Eaves,1983,1987,4,G,
1218,Devin Ebanks,2011,2013,2,F,
1219,Bill Ebben,1958,1958,0,G,
1220,Al Eberhard,1975,1978,3,F,
1221,Ndudi Ebi,2004,2005,1,F,
1222,Roy Ebron,1974,1974,0,C,
1223,Jaime Echenique,2022,2022,0,C,
1224,Jarell Eddie,2016,2018,2,G,F
1225,Patrick Eddie,1992,1992,0,C,
1226,Dike Eddleman,1950,1953,3,F,G
1227,Kenton Edelin,1985,1985,0,F,
1228,Charles Edge,1974,1975,1,F,
1229,Bobby Edmonds,1968,1970,2,F,
1230,Keith Edmonson,1983,1984,1,G,
1231,Tyus Edney,1996,2001,5,G,
1232,Anthony Edwards,2021,2022,1,G,
1233,Bill Edwards,1994,1994,0,F,
1234,Blue Edwards,1990,1999,9,G,F
1235,Carsen Edwards,2020,2021,1,G,
1236,Corsley Edwards,2005,2005,0,F,
1237,Doug Edwards,1994,1996,2,F,
1238,Franklin Edwards,1982,1988,6,G,
1239,James Edwards,1978,1996,18,C,F
1240,Jay Edwards,1990,1990,0,G,
1241,John Edwards,2005,2006,1,C,
1242,Kessler Edwards,2022,2022,0,F,
1243,Kevin Edwards,1989,2001,12,G,
1244,Rob Edwards,2022,2022,0,G,
1245,Shane Edwards,2014,2014,0,F,
1246,Vince Edwards,2019,2019,0,F,
1247,Johnny Egan,1962,1972,10,G,
1248,Lonnie Eggleston,1949,1949,0,G,
1249,Bulbs Ehlers,1948,1949,1,F,G
1250,Craig Ehlo,1984,1997,13,G,F
1251,Rich Eichhorst,1962,1962,0,G,
1252,Howard Eisley,1995,2006,11,G,
1253,Obinna Ekezie,2000,2005,5,F,C
1254,Khalid El-Amin,2001,2001,0,G,
1255,Don Eliason,1947,1947,0,F,
1256,Mario Elie,1991,2001,10,G,F
1257,CJ Elleby,2021,2022,1,F,
1258,Ray Ellefson,1949,1951,2,C,
1259,Henry Ellenson,2017,2021,4,F,
1260,Wayne Ellington,2010,2022,12,G,
1261,Bob Elliott,1979,1981,2,C,F
1262,Sean Elliott,1990,2001,11,F,
1263,Bo Ellis,1978,1980,2,F,
1264,Boo Ellis,1959,1960,1,F,
1265,Dale Ellis,1984,2000,16,G,F
1266,Harold Ellis,1994,1998,4,G,
1267,Joe Ellis,1967,1974,7,F,G
1268,LaPhonso Ellis,1993,2003,10,F,
1269,LeRon Ellis,1992,1996,4,F,C
1270,Leroy Ellis,1963,1976,13,C,F
1271,Monta Ellis,2006,2017,11,G,
1272,Pervis Ellison,1990,2001,11,F,C
1273,Len Elmore,1975,1984,9,C,F
1274,Francisco Elson,2004,2012,8,C,
1275,Darrell Elston,1975,1977,2,G,
1276,Melvin Ely,2003,2014,11,C,
1277,Joel Embiid,2017,2022,5,C,
1278,Wayne Embry*,1959,1969,10,C,F
1279,Andre Emmett,2005,2012,7,F,
1280,Ned Endress,1947,1947,0,F,G
1281,Wayne Engelstad,1989,1989,0,F,
1282,Chris Engler,1983,1988,5,C,
1283,A.J. English,1991,1992,1,G,
1284,Alex English*,1977,1991,14,F,
1285,Claude English,1971,1971,0,F,
1286,Jo Jo English,1993,1995,2,G,
1287,Kim English,2013,2013,0,G,
1288,Scott English,1973,1975,2,F,
1289,Gene Englund,1950,1950,0,F,C
1290,James Ennis III,2015,2022,7,F,
1291,Tyler Ennis,2015,2018,3,G,
1292,Ray Epps,1979,1979,0,F,
1293,Semih Erden,2011,2012,1,C,
1294,Bo Erias,1958,1958,0,F,
1295,Keith Erickson,1966,1977,11,F,G
1296,Julius Erving*,1972,1987,15,F,G
1297,Evan Eschmeyer,2000,2003,3,C,
1298,Jack Eskridge,1949,1949,0,C,F
1299,Vincenzo Esposito,1996,1996,0,G,
1300,Drew Eubanks,2019,2022,3,F,
1301,Billy Evans,1970,1970,0,G,
1302,Bob Evans,1950,1950,0,G,
1303,Brian Evans,1997,1999,2,F,
1304,Earl Evans,1980,1980,0,F,
1305,Jacob Evans,2019,2020,1,G,F
1306,Jawun Evans,2018,2019,1,G,
1307,Jeremy Evans,2011,2018,7,F,
1308,Maurice Evans,2002,2012,10,G,
1309,Mike Evans,1980,1988,8,G,
1310,Reggie Evans,2003,2015,12,F,
1311,Tyreke Evans,2010,2019,9,G,F
1312,Daniel Ewing,2006,2007,1,G,
1313,Patrick Ewing*,1986,2002,16,C,F
1314,Patrick Ewing,2011,2011,0,F,
1315,Dante Exum,2015,2021,6,G,
1316,Christian Eyenga,2011,2012,1,F,
1317,Festus Ezeli,2013,2016,3,C,
1318,Johnny Ezersky,1948,1950,2,F,G
1319,Joe Fabel,1947,1947,0,F,G
1320,John Fairchild,1966,1970,4,F,
1321,Tacko Fall,2020,2022,2,C,
1322,Phil Farbman,1949,1949,0,F,
1323,Kenneth Faried,2012,2019,7,F,C
1324,Dick Farley,1955,1959,4,G,F
1325,Jordan Farmar,2007,2017,10,G,
1326,Desmon Farmer,2007,2009,2,G,
1327,Jim Farmer,1988,1994,6,G,
1328,Mike Farmer,1959,1966,7,F,
1329,Tony Farmer,1998,2000,2,F,
1330,Bob Faught,1947,1947,0,F,
1331,Vítor Luiz Faverani,2014,2014,0,C,
1332,Derrick Favors,2011,2022,11,F,C
1333,Nick Fazekas,2008,2008,0,F,
1334,Dave Fedor,1963,1963,0,F,
1335,Bob Feerick,1947,1950,3,F,G
1336,Butch Feher,1977,1977,0,G,
1337,Jamie Feick,1997,2001,4,C,
1338,Ron Feiereisel,1956,1956,0,G,
1339,George Feigenbaum,1950,1953,3,G,
1340,Dave Feitl,1987,1992,5,C,
1341,Kay Felder,2017,2018,1,G,
1342,Cristiano Felício,2016,2021,5,F,C
1343,Carrick Felix,2014,2014,0,G,
1344,Noel Felix,2006,2006,0,F,
1345,Ray Felix,1954,1962,8,C,
1346,Raymond Felton,2006,2019,13,G,
1347,Jake Fendley,1952,1953,1,G,
1348,Warren Fenley,1947,1947,0,F,
1349,Desmond Ferguson,2004,2004,0,G,F
1350,Terrance Ferguson,2018,2021,3,G,F
1351,Rudy Fernández,2009,2012,3,G,
1352,Bruno Fernando,2020,2022,2,F,
1353,Eric Fernsten,1976,1984,8,C,F
1354,Al Ferrari,1956,1963,7,G,F
1355,Rolando Ferreira,1989,1989,0,C,
1356,Duane Ferrell,1989,1999,10,F,G
1357,Yogi Ferrell,2017,2021,4,G,
1358,Arnie Ferrin,1949,1951,2,F,G
1359,Bob Ferry,1960,1969,9,C,F
1360,Danny Ferry,1991,2003,12,F,
1361,Kyrylo Fesenko,2008,2012,4,C,
1362,Bobby Fields,1972,1972,0,G,
1363,Kenny Fields,1985,1988,3,F,G
1364,Landry Fields,2011,2015,4,F,
1365,Ron Filipek,1968,1968,0,F,
1366,Greg Fillmore,1971,1972,1,C,
1367,Larry Finch,1974,1975,1,G,
1368,Hank Finkel,1967,1975,8,C,
1369,Michael Finley,1996,2010,14,G,F
1370,Danny Finn,1953,1955,2,G,
1371,Dorian Finney-Smith,2017,2022,5,F,
1372,Matt Fish,1995,1997,2,C,
1373,Derek Fisher,1997,2014,17,G,
1374,Richard Fisher,1972,1972,0,F,
1375,Gerald Fitch,2006,2006,0,G,
1376,Malik Fitts,2021,2022,1,F,
1377,Bob Fitzgerald,1947,1949,2,F,C
1378,Dick Fitzgerald,1947,1948,1,F,
1379,Marcus Fizer,2001,2006,5,F,
1380,Jerry Fleishman,1947,1953,6,G,F
1381,Al Fleming,1978,1978,0,F,
1382,Ed Fleming,1956,1960,4,G,F
1383,Vern Fleming,1985,1996,11,G,
1384,Luis Flores,2005,2005,0,G,
1385,Bruce Flowers,1983,1983,0,F,
1386,Sleepy Floyd,1983,1995,12,G,
1387,Jonny Flynn,2010,2012,2,G,
1388,Malachi Flynn,2021,2022,1,G,
1389,Mike Flynn,1976,1978,2,G,
1390,Larry Fogle,1976,1976,0,G,
1391,Jack Foley,1963,1963,0,F,
1392,Isaac Fontaine,2002,2002,0,G,
1393,Levi Fontaine,1971,1971,0,G,
1394,Jeff Foote,2012,2012,0,C,
1395,Bryn Forbes,2017,2022,5,G,
1396,Gary Forbes,2011,2012,1,F,
1397,Aleem Ford,2022,2022,0,F,
1398,Alphonso Ford,1994,1995,1,G,
1399,Alton Ford,2002,2004,2,F,
1400,Bob Ford,1973,1973,0,F,
1401,Chris Ford,1973,1982,9,G,F
1402,Don Ford,1976,1982,6,F,
1403,Jake Ford,1971,1972,1,G,
1404,Phil Ford,1979,1985,6,G,
1405,Sharrod Ford,2006,2006,0,F,
1406,Sherell Ford,1996,1996,0,F,
1407,T.J. Ford,2004,2012,8,G,
1408,Donnie Forman,1949,1949,0,G,
1409,Bayard Forrest,1978,1979,1,C,
1410,Trent Forrest,2021,2022,1,G,
1411,Joseph Forte,2002,2003,1,G,
1412,Courtney Fortson,2012,2012,0,G,
1413,Danny Fortson,1998,2007,9,F,
1414,Fred Foster,1969,1977,8,F,
1415,Greg Foster,1991,2003,12,F,C
1416,Jeff Foster,2000,2012,12,F,C
1417,Jimmy Foster,1975,1976,1,G,
1418,Rod Foster,1984,1986,2,G,
1419,Antonis Fotsis,2002,2002,0,F,
1420,Evan Fournier,2013,2022,9,G,F
1421,Larry Foust,1951,1962,11,C,F
1422,Calvin Fowler,1970,1970,0,G,
1423,Jerry Fowler,1952,1952,0,C,
1424,Tremaine Fowlkes,2002,2005,3,F,
1425,De'Aaron Fox,2018,2022,4,G,
1426,Harold Fox,1973,1973,0,G,
1427,Jim Fox,1968,1977,9,C,F
1428,Rick Fox,1992,2004,12,F,G
1429,Randy Foye,2007,2017,10,G,
1430,Adonal Foyle,1998,2009,11,C,
1431,Richie Frahm,2004,2008,4,G,
1432,Steve Francis,2000,2008,8,G,
1433,Tellis Frank,1988,1994,6,F,C
1434,Nat Frankel,1947,1947,0,F,G
1435,Jamaal Franklin,2014,2015,1,G,
1436,William Franklin,1973,1976,3,F,
1437,Robert Franks,2021,2021,0,F,
1438,Ronald Franz,1968,1973,5,F,
1439,Melvin Frazier,2019,2020,1,G,
1440,Michael Frazier,2020,2020,0,G,
1441,Tim Frazier,2015,2022,7,G,
1442,Walt Frazier*,1968,1980,12,G,
1443,Will Frazier,1966,1969,3,C,F
1444,Anthony Frederick,1989,1992,3,F,
1445,Jimmer Fredette,2012,2019,7,G,
1446,World B. Free,1976,1988,12,G,
1447,Enes Freedom,2012,2022,10,C,
1448,Joel Freeland,2013,2015,2,F,C
1449,Donnie Freeman,1968,1976,8,G,
1450,Gary Freeman,1971,1971,0,F,
1451,Rod Freeman,1974,1974,0,F,
1452,Matt Freije,2005,2007,2,F,
1453,Frido Frey,1947,1947,0,F,
1454,Larry Friend,1958,1958,0,G,F
1455,Pat Frink,1969,1969,0,G,
1456,Jim Fritsche,1954,1955,1,F,C
1457,Channing Frye,2006,2019,13,C,F
1458,Bernie Fryer,1974,1975,1,G,
1459,Frank Fucarino,1947,1947,0,F,
1460,Herm Fuetsch,1948,1948,0,G,
1461,Joe Fulks*,1947,1954,7,F,C
1462,Carl Fuller,1971,1972,1,C,
1463,Hiram Fuller,2004,2004,0,F,
1464,Todd Fuller,1997,2001,4,C,
1465,Tony Fuller,1981,1981,0,G,
1466,Markelle Fultz,2018,2021,3,G,
1467,Lawrence Funderburke,1998,2005,7,F,
1468,Terry Furlow,1977,1980,3,G,F
1469,Bill Gabor,1950,1955,5,G,F
1470,Wenyen Gabriel,2020,2022,2,F,
1471,Dan Gadzuric,2003,2012,9,C,
1472,Daniel Gafford,2020,2022,2,F,
1473,Deng Gai,2006,2006,0,F,
1474,Elmer Gainer,1948,1950,2,F,C
1475,Bill Gaines,1969,1969,0,G,
1476,Corey Gaines,1989,1995,6,G,
1477,Reece Gaines,2004,2006,2,G,
1478,Smokey Gaines,1968,1968,0,G,
1479,Sundiata Gaines,2010,2012,2,G,
1480,Mike Gale,1972,1982,10,G,
1481,Chad Gallagher,1994,1994,0,C,
1482,Harry Gallatin*,1949,1958,9,F,C
1483,Gene Gallette,1947,1947,0,F,
1484,Danilo Gallinari,2009,2022,13,F,
1485,Langston Galloway,2015,2022,7,G,
1486,Dave Gambee,1959,1970,11,F,
1487,Kevin Gamble,1988,1997,9,F,G
1488,Bob Gantt,1947,1947,0,F,C
1489,Jorge Garbajosa,2007,2008,1,F,
1490,Rubén Garcés,2001,2001,0,F,
1491,Alex Garcia,2004,2005,1,G,
1492,Francisco García,2006,2015,9,F,G
1493,Chuck Gardner,1968,1968,0,F,
1494,Earl Gardner,1949,1949,0,F,
1495,Kenneth Gardner,1976,1976,0,F,
1496,Thomas Gardner,2008,2009,1,G,
1497,Vern Gardner,1950,1952,2,F,C
1498,Jack Garfinkel,1947,1949,2,G,
1499,Patricio Garino,2017,2017,0,G,F
1500,Darius Garland,2020,2022,2,G,
1501,Gary Garland,1980,1980,0,G,
1502,Winston Garland,1988,1995,7,G,
1503,Dick Garmaker,1956,1961,5,G,F
1504,Bill Garner,1968,1968,0,C,
1505,Chris Garner,1998,2001,3,G,
1506,Bill Garnett,1983,1986,3,F,
1507,Kevin Garnett*,1996,2016,20,F,C
1508,Marlon Garnett,1999,1999,0,G,
1509,Billy Garrett,2019,2019,0,G,
1510,Calvin Garrett,1981,1984,3,F,
1511,Dean Garrett,1997,2002,5,C,
1512,Diante Garrett,2013,2014,1,G,
1513,Dick Garrett,1970,1974,4,G,
1514,Marcus Garrett,2022,2022,0,G,
1515,Rowland Garrett,1973,1977,4,F,
1516,Tom Garrick,1989,1992,3,G,
1517,John Garris,1984,1984,0,F,
1518,Kiwane Lemorris Garris,1998,2000,2,G,
1519,Pat Garrity,1999,2008,9,F,
1520,Usman Garuba,2022,2022,0,F,
1521,Jim Garvin,1974,1974,0,F,
1522,Luka Garza,2022,2022,0,F,C
1523,Marc Gasol,2009,2021,12,C,
1524,Pau Gasol,2002,2019,17,C,F
1525,Frank Gates,1950,1950,0,G,
1526,Chris Gatling,1992,2002,10,F,C
1527,Kenny Gattison,1987,1996,9,F,C
1528,Rudy Gay,2007,2022,15,F,
1529,Ed Gayda,1951,1951,0,G,F
1530,Andrew Gaze,1994,1999,5,G,
1531,Michael Gbinije,2017,2017,0,G,
1532,Reggie Geary,1997,1998,1,G,
1533,Alonzo Gee,2010,2017,7,G,
1534,Matt Geiger,1993,2002,9,C,
1535,Mickaël Gelabale,2007,2013,6,F,
1536,Devean George,2000,2010,10,G,F
1537,Jack George,1954,1961,7,G,
1538,Paul George,2011,2022,11,F,
1539,Tate George,1991,1995,4,G,
1540,Marcus Georges-Hunt,2017,2018,1,G,
1541,Gus Gerard,1975,1981,6,F,G
1542,Derrick Gervin,1990,1991,1,F,
1543,George Gervin*,1973,1986,13,G,F
1544,Gorham Getchell,1947,1947,0,C,
1545,John Gianelli,1973,1980,7,C,F
1546,Dick Gibbs,1972,1976,4,F,G
1547,Daniel Gibson,2007,2013,6,G,
1548,Dee Gibson,1950,1950,0,F,G
1549,Hoot Gibson,1950,1950,0,F,C
1550,Jonathan Gibson,2017,2018,1,G,
1551,Mel Gibson,1964,1964,0,G,
1552,Mike Gibson,1984,1986,2,F,
1553,Taj Gibson,2010,2022,12,F,
1554,J.R. Giddens,2009,2010,1,G,
1555,Josh Giddey,2022,2022,0,G,
1556,Trey Gilder,2010,2010,0,F,
1557,Harry Giles,2019,2021,2,F,C
1558,Shai Gilgeous-Alexander,2019,2022,3,G,
1559,Anthony Gill,2021,2022,1,F,
1560,Eddie Gill,2001,2009,8,G,
1561,Kendall Gill,1991,2005,14,G,
1562,Ben Gillery,1989,1989,0,C,
1563,Freddie Gillespie,2021,2022,1,F,
1564,Jack Gillespie,1970,1970,0,F,
1565,Armen Gilliam,1988,2000,12,F,C
1566,Herm Gilliam,1970,1977,7,G,F
1567,Artis Gilmore*,1972,1988,16,C,
1568,Walt Gilmore,1971,1971,0,F,
1569,Chuck Gilmur,1947,1951,4,F,C
1570,Manu Ginóbili,2003,2018,15,G,
1571,Gordan Giriček,2003,2008,5,G,F
1572,Jack Givens,1979,1980,1,F,G
1573,Mickell Gladness,2012,2012,0,C,
1574,George Glamack,1949,1949,0,C,F
1575,Gerald Glass,1991,1996,5,G,F
1576,Mike Glenn,1978,1987,9,G,
1577,Normie Glick,1950,1950,0,F,
1578,Georgi Glouchkov,1986,1986,0,F,
1579,Clarence Glover,1972,1972,0,F,
1580,Dion Glover,2000,2005,5,G,
1581,Andreas Glyniadakis,2007,2007,0,C,
1582,Mike Gminski,1981,1994,13,C,
1583,Rudy Gobert,2014,2022,8,C,
1584,Dan Godfread,1991,1992,1,C,
1585,Tom Gola*,1956,1966,10,G,F
1586,Ben Goldfaden,1947,1947,0,F,
1587,Anthony Goldwire,1996,2006,10,G,
1588,Ryan Gomes,2006,2014,8,F,
1589,Glen Gondrezick,1978,1983,5,F,G
1590,Grant Gondrezick,1987,1989,2,G,
1591,Drew Gooden,2003,2016,13,F,
1592,Gail Goodrich*,1966,1979,13,G,
1593,Steve Goodrich,2001,2002,1,F,
1594,Archie Goodwin,2014,2017,3,G,
1595,Brandon Goodwin,2019,2022,3,G,
1596,Jordan Goodwin,2022,2022,0,G,
1597,Pop Goodwin,1947,1948,1,F,C
1598,Aaron Gordon,2015,2022,7,F,
1599,Ben Gordon,2005,2015,10,G,
1600,Drew Gordon,2015,2015,0,F,
1601,Eric Gordon,2009,2022,13,G,F
1602,Lancaster Gordon,1985,1988,3,G,
1603,Paul Gordon,1950,1950,0,F,
1604,Marcin Gortat,2008,2019,11,C,F
1605,Leo Gottlieb,1947,1948,1,G,
1606,Andrew Goudelock,2012,2016,4,G,
1607,Gerald Govan,1968,1976,8,F,C
1608,Bato Govedarica,1954,1954,0,G,
1609,Joe Graboski,1949,1962,13,F,C
1610,Ricky Grace,1994,1994,0,G,
1611,Calvin Graham,1968,1968,0,G,
1612,Devonte' Graham,2019,2022,3,G,
1613,Greg Graham,1994,1998,4,G,
1614,Joey Graham,2006,2011,5,F,
1615,Mal Graham,1968,1969,1,G,
1616,Orlando Graham,1989,1989,0,F,
1617,Paul Graham,1992,1994,2,F,G
1618,Stephen Graham,2006,2011,5,G,
1619,Treveon Graham,2017,2020,3,G,
1620,Jim Grandholm,1991,1991,0,F,C
1621,Ron Grandison,1989,1996,7,F,
1622,Danny Granger,2006,2015,9,F,
1623,Stewart Granger,1984,1987,3,G,
1624,Brian Grant,1995,2006,11,F,
1625,Bud Grant,1950,1951,1,F,
1626,Gary Grant,1989,2001,12,G,
1627,Greg Grant,1990,1996,6,G,
1628,Harvey Grant,1989,1999,10,F,
1629,Horace Grant,1988,2004,16,F,C
1630,Jerami Grant,2015,2022,7,F,
1631,Jerian Grant,2016,2020,4,G,
1632,Josh Grant,1994,1994,0,F,
1633,Paul Grant,1999,2004,5,C,
1634,Travis Grant,1973,1976,3,F,
1635,Donte Grantham,2019,2019,0,F,
1636,Don Grate,1950,1950,0,F,G
1637,Butch Graves,1985,1985,0,G,
1638,Hassani Gravett,2022,2022,0,G,
1639,Aaron Gray,2008,2014,6,C,
1640,Devin Gray,1997,2000,3,F,
1641,Ed Gray,1998,1999,1,G,
1642,Evric Gray,1997,1997,0,F,
1643,Gary Gray,1968,1968,0,G,
1644,Josh Gray,2018,2020,2,G,
1645,Leonard Gray,1975,1977,2,F,
1646,Stuart Gray,1985,1991,6,C,F
1647,Sylvester Gray,1989,1989,0,F,
1648,Wyndol Gray,1947,1948,1,G,F
1649,Jeff Grayer,1989,1998,9,F,G
1650,Bob Greacen,1970,1972,2,F,
1651,A.C. Green,1986,2001,15,F,C
1652,Danny Green,2010,2022,12,G,F
1653,Devin Green,2006,2006,0,G,
1654,Draymond Green,2013,2022,9,F,
1655,Erick Green,2015,2016,1,G,
1656,Gerald Green,2006,2019,13,G,F
1657,Jalen Green,2022,2022,0,G,
1658,JaMychal Green,2015,2022,7,F,
1659,Javonte Green,2020,2022,2,F,
1660,Jeff Green,2008,2022,14,F,
1661,Johnny Green,1960,1973,13,F,C
1662,Josh Green,2021,2022,1,G,F
1663,Ken Green,1986,1986,0,F,
1664,Kenny Green,1986,1987,1,F,
1665,Lamar Green,1970,1975,5,F,C
1666,Litterial Green,1993,1999,6,G,
1667,Luther Green,1970,1973,3,F,
1668,Mike Green,1974,1980,6,C,F
1669,Rickey Green,1978,1992,14,G,
1670,Sean Green,1992,1994,2,G,F
1671,Si Green,1957,1966,9,G,F
1672,Sidney Green,1984,1993,9,F,C
1673,Steve Green,1976,1979,3,F,
1674,Taurean Green,2008,2008,0,G,
1675,Tommie Green,1979,1979,0,G,
1676,Willie Green,2004,2015,11,G,
1677,Donté Greene,2009,2012,3,F,
1678,Orien Greene,2006,2011,5,G,
1679,Jerry Greenspan,1964,1965,1,F,
1680,Dave Greenwood,1980,1991,11,F,C
1681,Hal Greer*,1959,1973,14,G,F
1682,Lynn Greer,2007,2007,0,G,
1683,Gary Gregor,1969,1974,5,F,C
1684,Claude Gregory,1986,1988,2,F,
1685,John Greig,1983,1983,0,F,
1686,Norm Grekin,1954,1954,0,F,
1687,Kevin Grevey,1976,1985,9,G,F
1688,Dennis Grey,1969,1970,1,C,F
1689,Adrian Griffin,2000,2008,8,G,F
1690,Blake Griffin,2011,2022,11,F,
1691,Eddie Griffin,2002,2007,5,F,C
1692,Greg Griffin,1978,1978,0,F,
1693,Paul Griffin,1977,1983,6,F,C
1694,Taylor Griffin,2010,2010,0,F,
1695,Darrell Griffith,1981,1991,10,G,
1696,Chuck Grigsby,1955,1955,0,G,
1697,Quentin Grimes,2022,2022,0,G,
1698,Derek Grimm,1998,1998,0,F,
1699,Woody Grimshaw,1947,1947,0,G,
1700,Dick Groat,1953,1953,0,G,
1701,Bob Gross,1976,1983,7,F,G
1702,Mike Grosso,1972,1972,0,C,
1703,Jerry Grote,1965,1965,0,G,
1704,Alex Groza,1950,1951,1,C,
1705,Dick Grubar,1970,1970,0,G,
1706,Anthony Grundy,2006,2006,0,G,
1707,Ernie Grunfeld,1978,1986,8,G,F
1708,Gene Guarilia,1960,1963,3,F,
1709,Pétur Guðmundsson,1982,1989,7,C,
1710,Marko Guduric,2020,2020,0,G,
1711,Richie Guerin*,1957,1970,13,G,
1712,Tom Gugliotta,1993,2005,12,F,
1713,Andrés Guibert,1994,1995,1,F,C
1714,Jay Guidinger,1993,1994,1,C,
1715,Coulby Gunther,1947,1949,2,F,
1716,Dave Gunther,1963,1963,0,F,
1717,Al Guokas,1950,1950,0,F,G
1718,Matt Guokas,1947,1947,0,F,
1719,Matt Guokas,1967,1976,9,G,F
1720,Jorge Gutiérrez,2014,2016,2,G,
1721,Kyle Guy,2020,2022,2,G,
1722,A.J. Guyton,2001,2003,2,G,
1723,Rui Hachimura,2020,2022,2,F,
1724,Rudy Hackett,1976,1977,1,F,
1725,Hamed Haddadi,2009,2013,4,C,
1726,Jim Hadnot,1968,1968,0,C,F
1727,Scott Haffner,1990,1991,1,G,
1728,Cliff Hagan*,1957,1970,13,F,G
1729,Glenn Hagan,1982,1982,0,G,
1730,Tom Hagan,1970,1971,1,G,
1731,Ashton Hagans,2021,2021,0,G,
1732,Robert Hahn,1950,1950,0,C,
1733,Al Hairston,1969,1970,1,G,
1734,Happy Hairston,1965,1975,10,F,
1735,Lindsay Hairston,1976,1976,0,F,C
1736,Malik Hairston,2009,2010,1,G,
1737,P.J. Hairston,2015,2016,1,G,F
1738,Marcus Haislip,2003,2010,7,F,
1739,Chick Halbert,1947,1951,4,C,
1740,Swede Halbrook,1961,1962,1,C,
1741,Bruce Hale,1949,1951,2,G,F
1742,Hal Hale,1968,1968,0,G,
1743,Jack Haley,1989,1998,9,C,F
1744,Tyrese Haliburton,2021,2022,1,G,
1745,Shaler Halimon,1969,1973,4,G,F
1746,Devon Hall,2020,2020,0,G,
1747,Donta Hall,2020,2021,1,F,
1748,Josh Hall,2021,2021,0,F,
1749,Mike Hall,2007,2007,0,F,
1750,Tyler Hall,2022,2022,0,G,
1751,Jeff Halliburton,1972,1973,1,G,
1752,Darvin Ham,1997,2005,8,F,
1753,Steve Hamer,1997,1997,0,C,
1754,Dale Hamilton,1950,1950,0,G,F
1755,Daniel Hamilton,2018,2019,1,G,F
1756,Dennis Hamilton,1968,1971,3,F,
1757,Joe Hamilton,1971,1976,5,G,
1758,Jordan Hamilton,2012,2016,4,G,F
1759,Justin Hamilton,2014,2017,3,C,
1760,Ralph Hamilton,1949,1949,0,G,F
1761,Richard Hamilton,2000,2013,13,G,F
1762,Roy Hamilton,1980,1981,1,G,
1763,Steve Hamilton,1959,1960,1,F,C
1764,Tang Hamilton,2002,2002,0,F,
1765,Thomas Hamilton,1996,2000,4,C,
1766,Zendon Hamilton,2001,2006,5,C,F
1767,Geert Hammink,1994,1996,2,C,
1768,Julian Hammond,1968,1972,4,F,
1769,Tom Hammonds,1990,2001,11,F,
1770,A.J. Hammons,2017,2017,0,C,
1771,Joe Hamood,1968,1968,0,G,
1772,R.J. Hampton,2021,2022,1,G,
1773,Darrin Hancock,1995,1997,2,G,F
1774,Ben Handlogten,2004,2005,1,C,
1775,Cecil Hankins,1947,1948,1,G,
1776,Phil Hankinson,1974,1975,1,F,
1777,Dusty Hannahs,2019,2020,1,G,
1778,Alex Hannum*,1950,1957,7,F,C
1779,Don Hanrahan,1953,1953,0,F,
1780,Rollen Hans,1954,1955,1,G,
1781,Ben Hansbrough,2013,2013,0,G,
1782,Tyler Hansbrough,2010,2016,6,F,
1783,Bob Hansen,1984,1992,8,G,
1784,Glenn Hansen,1976,1978,2,G,
1785,Lars Hansen,1979,1979,0,C,
1786,Travis Hansen,2004,2004,0,G,
1787,Reggie Hanson,1998,1998,0,F,
1788,Bill Hanzlik,1981,1990,9,G,F
1789,Luke Harangody,2011,2012,1,F,
1790,Anfernee Hardaway,1994,2008,14,G,F
1791,Tim Hardaway,1990,2003,13,G,
1792,Tim Hardaway Jr.,2014,2022,8,G,
1793,James Harden,2010,2022,12,G,
1794,Reggie Harding,1964,1968,4,C,
1795,Charlie Hardnett,1963,1965,2,F,C
1796,Alan Hardy,1981,1982,1,F,
1797,Darrell Hardy,1968,1968,0,F,
1798,James Hardy,1979,1982,3,F,C
1799,Ira Harge,1968,1973,5,C,
1800,John Hargis,1950,1951,1,G,F
1801,Maurice Harkless,2013,2022,9,F,G
1802,Jerry Harkness,1964,1969,5,G,
1803,Skip Harlicka,1969,1969,0,G,
1804,Jerome Harmon,1995,1995,0,G,
1805,Derek Harper,1984,1999,15,G,
1806,Jared Harper,2020,2022,2,G,
1807,Justin Harper,2012,2017,5,F,
1808,Mike Harper,1981,1982,1,C,F
1809,Ron Harper,1987,2001,14,G,F
1810,Matt Harpring,1999,2009,10,F,
1811,Montrezl Harrell,2016,2022,6,F,C
1812,Josh Harrellson,2012,2014,2,C,
1813,Adam Harrington,2003,2003,0,G,
1814,Al Harrington,1999,2014,15,F,
1815,Junior Harrington,2003,2007,4,G,
1816,Othella Harrington,1997,2008,11,F,C
1817,Art Harris,1969,1972,3,G,
1818,Bernie Harris,1975,1975,0,F,
1819,Billy Harris,1975,1975,0,G,
1820,Bob Harris,1950,1954,4,F,C
1821,Chris Harris,1956,1956,0,G,
1822,Devin Harris,2005,2019,14,G,
1823,Elias Harris,2014,2014,0,F,
1824,Gary Harris,2015,2022,7,G,
1825,Jalen Harris,2021,2021,0,G,
1826,Joe Harris,2015,2022,7,G,
1827,Lucious Harris,1994,2005,11,G,
1828,Manny Harris,2011,2017,6,G,
1829,Mike Harris,2008,2014,6,F,
1830,Steve Harris,1986,1990,4,G,
1831,Terrel Harris,2012,2013,1,G,
1832,Tobias Harris,2012,2022,10,F,
1833,Tony Harris,1991,1995,4,G,
1834,Aaron Harrison,2016,2018,2,G,
1835,Andrew Harrison,2017,2019,2,G,
1836,Bob Harrison,1950,1958,8,G,
1837,David Harrison,2005,2008,3,C,
1838,Shaquille Harrison,2018,2022,4,G,
1839,Jason Hart,2001,2010,9,G,
1840,Josh Hart,2018,2022,4,G,
1841,Isaiah Hartenstein,2019,2022,3,F,
1842,Antonio Harvey,1994,2003,9,F,C
1843,Donnell Harvey,2001,2005,4,F,
1844,Scott Haskin,1994,1994,0,C,F
1845,Clem Haskins,1968,1976,8,G,
1846,Udonis Haslem,2004,2022,18,F,C
1847,Trenton Hassell,2002,2010,8,G,
1848,Billy Hassett,1950,1951,1,G,
1849,Joe Hassett,1978,1983,5,G,
1850,Scott Hastings,1983,1993,10,F,C
1851,Kirk Haston,2002,2003,1,F,
1852,Vern Hatton,1959,1962,3,G,
1853,Sam Hauser,2022,2022,0,F,
1854,John Havlicek*,1963,1978,15,F,G
1855,Spencer Hawes,2008,2017,9,C,F
1856,Steve Hawes,1975,1984,9,C,F
1857,Bubbles Hawkins,1976,1979,3,G,
1858,Connie Hawkins*,1968,1976,8,F,C
1859,Hersey Hawkins,1989,2001,12,G,
1860,Juaquin Hawkins,2003,2003,0,G,F
1861,Marshall Hawkins,1950,1950,0,F,
1862,Michael Hawkins,1997,2001,4,G,
1863,Tom Hawkins,1960,1969,9,F,
1864,Nate Hawthorne,1974,1976,2,G,
1865,Chuck Hayes,2006,2016,10,F,C
1866,Elvin Hayes*,1969,1984,15,F,C
1867,Jarvis Hayes,2004,2010,6,F,
1868,Jaxson Hayes,2020,2022,2,F,
1869,Jim Hayes,1971,1971,0,G,
1870,Killian Hayes,2021,2022,1,G,
1871,Nigel Hayes,2018,2018,0,F,
1872,Steve Hayes,1982,1986,4,C,
1873,Gordon Hayward,2011,2022,11,F,G
1874,Lazar Hayward,2011,2013,2,F,
1875,Brendan Haywood,2002,2015,13,C,
1876,Spencer Haywood*,1970,1983,13,F,C
1877,John Hazen,1949,1949,0,G,
1878,Walt Hazzard,1965,1974,9,G,
1879,Luther Head,2006,2011,5,G,
1880,Shane Heal,1997,2004,7,G,
1881,Brian Heaney,1970,1970,0,G,
1882,Gar Heard,1971,1981,10,F,
1883,Reggie Hearn,2018,2018,0,G,
1884,Herm Hedderick,1955,1955,0,G,
1885,Alvin Heggs,1996,1996,0,F,
1886,Tom Heinsohn*,1957,1965,8,F,C
1887,Dick Hemric,1956,1957,1,F,
1888,Alan Henderson,1996,2007,11,F,
1889,Cedric Henderson,1987,1987,0,F,
1890,Cedric Henderson,1998,2002,4,F,
1891,Dave Henderson,1988,1988,0,G,
1892,Gerald Henderson,1980,1992,12,G,
1893,Gerald Henderson,2010,2017,7,G,
1894,J.R. Henderson,1999,1999,0,F,
1895,Jerome Henderson,1986,1987,1,C,F
1896,Kevin Henderson,1987,1988,1,G,
1897,Tom Henderson,1975,1983,8,G,
1898,Mark Hendrickson,1997,2000,3,F,
1899,Larry Hennessy,1956,1957,1,G,
1900,Don Henriksen,1953,1955,2,F,C
1901,Aaron Henry,2022,2022,0,F,
1902,Al Henry,1971,1972,1,C,
1903,Bill Henry,1949,1950,1,C,
1904,Carl Henry,1986,1986,0,G,
1905,Conner Henry,1987,1988,1,G,
1906,Myke Henry,2018,2018,0,F,
1907,Skeeter Henry,1994,1994,0,G,
1908,Xavier Henry,2011,2015,4,G,
1909,John Henson,2013,2020,7,C,F
1910,Steve Henson,1991,1999,8,G,
1911,Charles Hentz,1971,1971,0,F,
1912,Bill Herman,1950,1950,0,G,
1913,Kleggie Hermsen,1947,1953,6,C,F
1914,Dewan Hernandez,2020,2020,0,F,
1915,Juancho Hernangómez,2017,2022,5,F,
1916,Willy Hernangómez,2017,2022,5,C,
1917,Chris Herren,2000,2001,1,G,
1918,Carl Herrera,1992,1999,7,F,
1919,Walter Herrmann,2007,2009,2,F,
1920,Tyler Herro,2020,2022,2,G,
1921,Keith Herron,1979,1982,3,G,F
1922,Sonny Hertzberg,1947,1951,4,G,
1923,Kevin Hervey,2020,2020,0,F,
1924,Dan Hester,1971,1971,0,F,
1925,Fred Hetzel,1966,1971,5,F,C
1926,Bill Hewitt,1969,1975,6,F,
1927,Jack Hewson,1948,1948,0,F,C
1928,Art Heyman,1964,1970,6,F,G
1929,Mario Hezonja,2016,2020,4,F,G
1930,Roy Hibbert,2009,2017,8,C,
1931,Nat Hickey,1948,1948,0,G,F
1932,Isaiah Hicks,2018,2019,1,F,
1933,Phil Hicks,1977,1979,2,F,
1934,J.J. Hickson,2009,2016,7,F,C
1935,Buddy Hield,2017,2022,5,G,
1936,Bill Higgins,1975,1975,0,G,
1937,Cory Higgins,2012,2013,1,G,
1938,Earle Higgins,1971,1971,0,F,
1939,Mike Higgins,1990,1991,1,F,
1940,Rod Higgins,1983,1995,12,F,
1941,Sean Higgins,1991,1998,7,G,F
1942,Kenny Higgs,1979,1982,3,G,
1943,Johnny High,1980,1984,4,G,
1944,Haywood Highsmith,2019,2022,3,F,
1945,Wayne Hightower,1963,1972,9,F,C
1946,Nenê,2003,2019,16,F,C
1947,Armond Hill,1977,1984,7,G,
1948,Cleo Hill,1962,1962,0,G,
1949,Gary Hill,1964,1965,1,G,
1950,George Hill,2009,2022,13,G,
1951,Grant Hill*,1995,2013,18,F,G
1952,Jordan Hill,2010,2017,7,C,F
1953,Malcolm Hill,2022,2022,0,F,
1954,Simmie Hill,1970,1974,4,F,
1955,Solomon Hill,2014,2022,8,F,
1956,Steven Hill,2009,2009,0,C,
1957,Tyrone Hill,1991,2004,13,F,
1958,Art Hillhouse,1947,1948,1,C,
1959,Darrun Hilliard,2016,2018,2,G,
1960,Darnell Hillman,1972,1980,8,F,C
1961,Fred Hilton,1972,1973,1,G,F
1962,Kirk Hinrich,2004,2016,12,G,
1963,Roy Hinson,1984,1991,7,F,C
1964,Nate Hinton,2021,2022,1,G,
1965,Mel Hirsch,1947,1947,0,G,
1966,Lew Hitch,1952,1957,5,F,C
1967,Robert Hite,2007,2007,0,G,
1968,Jaylen Hoard,2020,2022,2,F,
1969,Darington Hobson,2012,2012,0,G,
1970,Donald Hodge,1992,1996,4,C,
1971,Julius Hodge,2006,2007,1,G,
1972,Craig Hodges,1983,1992,9,G,
1973,Charlie Hoefer,1947,1948,1,G,
1974,Paul Hoffman,1948,1955,7,G,F
1975,Bob Hogsett,1967,1968,1,F,
1976,Paul Hogue,1963,1964,1,C,
1977,Fred Hoiberg,1996,2005,9,G,
1978,Doug Holcomb,1949,1949,0,F,
1979,Randy Holcomb,2006,2006,0,F,
1980,Aaron Holiday,2019,2022,3,G,
1981,Jrue Holiday,2010,2022,12,G,
1982,Justin Holiday,2013,2022,9,F,
1983,Brad Holland,1980,1982,2,G,
1984,Joe Holland,1950,1952,2,F,
1985,John Holland,2018,2019,1,G,F
1986,Wilbur Holland,1976,1979,3,G,
1987,Lionel Hollins,1976,1985,9,G,
1988,Ryan Hollins,2007,2016,9,C,
1989,Essie Hollis,1979,1979,0,F,
1990,Rondae Hollis-Jefferson,2016,2021,5,F,
1991,Dennis Holman,1968,1968,0,G,
1992,Richaun Holmes,2016,2022,6,F,C
1993,Jim Holstein,1953,1956,3,F,G
1994,A.W. Holt,1971,1971,0,F,
1995,Michael Holton,1985,1990,5,G,
1996,Dick Holub,1948,1948,0,C,
1997,Joe Holup,1957,1959,2,F,
1998,Red Holzman*,1949,1954,5,G,
1999,Jerald Honeycutt,1998,1999,1,F,G
2000,Tyler Honeycutt,2012,2013,1,F,
2001,Derek Hood,2000,2000,0,F,
2002,Rodney Hood,2015,2022,7,G,F
2003,Bobby Hooper,1969,1969,0,G,
2004,Carroll Hooser,1968,1968,0,F,
2005,Tom Hoover,1964,1969,5,C,
2006,Bob Hopkins,1957,1960,3,C,F
2007,Dave Hoppen,1988,1993,5,C,F
2008,Dennis Hopson,1988,1992,4,G,F
2009,Scotty Hopson,2014,2022,8,G,
2010,Johnny Horan,1956,1956,0,F,
2011,Cedrick Hordges,1981,1982,1,F,C
2012,Al Horford,2008,2022,14,C,F
2013,Tito Horford,1989,1994,5,C,
2014,Ron Horn,1962,1968,6,F,
2015,Jeff Hornacek,1987,2000,13,G,
2016,Dennis Horner,2012,2012,0,F,
2017,Robert Horry,1993,2008,15,F,
2018,Ed Horton,1990,1990,0,F,
2019,Talen Horton-Tucker,2020,2022,2,G,F
2020,Bill Hosket,1969,1972,3,F,C
2021,Bob Houbregs*,1954,1958,4,C,F
2022,Danuel House Jr.,2017,2022,5,G,
2023,Eddie House,2001,2011,10,G,
2024,Allan Houston,1994,2005,11,G,
2025,Byron Houston,1993,1996,3,F,
2026,Tom Hovasse,1995,1995,0,F,
2027,Brian Howard,1992,1993,1,F,
2028,Dwight Howard,2005,2022,17,C,
2029,Greg Howard,1971,1972,1,F,C
2030,Josh Howard,2004,2013,9,F,G
2031,Juwan Howard,1995,2013,18,F,
2032,Markus Howard,2021,2022,1,G,
2033,Mo Howard,1977,1977,0,G,
2034,Otis Howard,1979,1979,0,F,
2035,Stephen Howard,1993,1998,5,F,
2036,William Howard,2020,2020,0,F,
2037,Bailey Howell*,1960,1971,11,F,
2038,Bob Hubbard,1948,1949,1,C,F
2039,Phil Hubbard,1980,1989,9,F,C
2040,Lester Hudson,2010,2015,5,G,
2041,Lou Hudson,1967,1979,12,F,G
2042,Troy Hudson,1998,2008,10,G,
2043,Marcelo Huertas,2016,2017,1,G,
2044,Kevin Huerter,2019,2022,3,G,
2045,Josh Huestis,2016,2018,2,F,
2046,Jay Huff,2022,2022,0,F,C
2047,Nate Huffman,2003,2003,0,C,
2048,Alfredrick Hughes,1986,1986,0,F,G
2049,Eddie Hughes,1988,1990,2,G,
2050,Elijah Hughes,2021,2022,1,F,
2051,Kim Hughes,1976,1981,5,C,
2052,Larry Hughes,1999,2012,13,G,
2053,Rick Hughes,2000,2000,0,F,
2054,Robbie Hummel,2014,2015,1,F,
2055,John Hummer,1971,1976,5,F,C
2056,Ryan Humphrey,2003,2005,2,F,
2057,Isaac Humphries,2019,2019,0,C,
2058,Jay Humphries,1985,1995,10,G,
2059,Kris Humphries,2005,2017,12,F,C
2060,Hot Rod Hundley,1958,1963,5,G,
2061,Brandon Hunter,2004,2005,1,F,
2062,Cedric Hunter,1992,1992,0,G,
2063,Chris Hunter,2010,2010,0,F,
2064,De'Andre Hunter,2020,2022,2,F,
2065,Les Hunter,1965,1973,8,F,C
2066,Lindsey Hunter,1994,2010,16,G,
2067,Othello Hunter,2009,2010,1,F,
2068,R.J. Hunter,2016,2019,3,G,
2069,Steven Hunter,2002,2010,8,C,
2070,Vince Hunter,2018,2018,0,F,
2071,Bobby Hurley,1994,1998,4,G,
2072,Roy Hurley,1947,1947,0,F,G
2073,Geoff Huston,1980,1987,7,G,
2074,Paul Huston,1948,1948,0,F,
2075,Mel Hutchins,1952,1958,6,F,C
2076,Chandler Hutchison,2019,2022,3,G,
2077,Joe Hutton,1951,1952,1,G,
2078,Greg Hyder,1971,1971,0,F,
2079,Bones Hyland,2022,2022,0,G,
2080,Marc Iavaroni,1983,1989,6,F,
2081,Serge Ibaka,2010,2022,12,F,C
2082,Andre Iguodala,2005,2022,17,G,F
2083,Zydrunas Ilgauskas,1998,2011,13,C,
2084,Mile Ilić,2007,2007,0,C,
2085,D.J. Mbenga,2005,2011,6,C,
2086,Ersan İlyasova,2007,2021,14,F,
2087,Darrall Imhoff,1961,1972,11,C,
2088,Tom Ingelsby,1974,1976,2,G,
2089,Joe Ingles,2015,2022,7,F,G
2090,Damien Inglis,2016,2016,0,F,
2091,Andre Ingram,2018,2019,1,G,
2092,Brandon Ingram,2017,2022,5,F,
2093,McCoy Ingram,1958,1958,0,F,
2094,Ervin Inniger,1968,1969,1,G,
2095,Byron Irvin,1990,1993,3,G,
2096,George Irvine,1971,1976,5,F,G
2097,Kyrie Irving,2012,2022,10,G,
2098,Jonathan Isaac,2018,2020,2,F,
2099,Dan Issel*,1971,1985,14,C,F
2100,Mike Iuzzolino,1992,1993,1,G,
2101,Allen Iverson*,1997,2010,13,G,
2102,Willie Iverson,1969,1969,0,G,
2103,Royal Ivey,2005,2014,9,G,
2104,Elvin Ivory,1969,1969,0,F,
2105,Wes Iwundu,2018,2022,4,F,
2106,Warren Jabali,1969,1975,6,G,F
2107,Jarrett Jack,2006,2018,12,G,
2108,Aaron Jackson,2018,2018,0,G,
2109,Al Jackson,1968,1968,0,G,
2110,Bobby Jackson,1998,2009,11,G,
2111,Cedric Jackson,2010,2010,0,G,
2112,Darnell Jackson,2009,2011,2,F,
2113,Demetrius Jackson,2017,2019,2,G,
2114,Frank Jackson,2019,2022,3,G,
2115,Greg Jackson,1975,1975,0,G,
2116,Isaiah Jackson,2022,2022,0,F,C
2117,Jaren Jackson,1990,2002,12,G,F
2118,Jaren Jackson Jr.,2019,2022,3,F,
2119,Jermaine Jackson,2000,2006,6,G,
2120,Jim Jackson,1993,2006,13,G,
2121,Josh Jackson,2018,2022,4,F,G
2122,Justin Jackson,2018,2022,4,G,F
2123,Luke Jackson,1965,1972,7,F,C
2124,Luke Jackson,2005,2008,3,F,
2125,Marc Jackson,2001,2007,6,C,
2126,Mark Jackson,1988,2004,16,G,
2127,Mervin Jackson,1969,1973,4,G,
2128,Michael Jackson,1988,1990,2,G,
2129,Mike Jackson,1973,1976,3,F,
2130,Myron Jackson,1987,1987,0,G,
2131,Phil Jackson*,1968,1980,12,F,C
2132,Pierre Jackson,2017,2017,0,G,
2133,Ralph Jackson,1985,1985,0,G,
2134,Randell Jackson,1999,2000,1,F,
2135,Reggie Jackson,2012,2022,10,G,
2136,Stanley Jackson,1994,1994,0,G,
2137,Stephen Jackson,2001,2014,13,F,G
2138,Tony Jackson,1968,1969,1,F,G
2139,Tony Jackson,1981,1981,0,G,
2140,Tracy Jackson,1982,1984,2,G,F
2141,Wardell Jackson,1975,1975,0,F,
2142,Fred Jacobs,1947,1947,0,F,
2143,Casey Jacobsen,2003,2008,5,G,F
2144,Sam Jacobson,1999,2001,2,G,F
2145,Dave Jamerson,1991,1994,3,G,F
2146,Aaron James,1975,1979,4,F,
2147,Bernard James,2013,2015,2,C,
2148,Billy James,1974,1974,0,G,
2149,Damion James,2011,2014,3,G,F
2150,Gene James,1949,1951,2,F,
2151,Henry James,1991,1998,7,F,
2152,Jerome James,1999,2009,10,C,
2153,Justin James,2020,2021,1,G,
2154,LeBron James,2004,2022,18,F,G
2155,Mike James,2002,2014,12,G,
2156,Mike James,2018,2021,3,G,
2157,Tim James,2000,2002,2,F,
2158,Antawn Jamison,1999,2014,15,F,
2159,Harold Jamison,2000,2002,2,F,
2160,John Janisch,1947,1948,1,F,G
2161,Howie Janotta,1950,1950,0,F,
2162,Marko Jarić,2003,2009,6,G,
2163,Tony Jaros,1947,1951,4,F,G
2164,DeJon Jarreau,2022,2022,0,G,
2165,Jim Jarvis,1968,1969,1,G,
2166,Šarūnas Jasikevičius,2006,2007,1,G,
2167,Nathan Jawai,2009,2010,1,C,F
2168,Buddy Jeannette*,1948,1950,2,G,
2169,Abdul Jeelani,1980,1981,1,F,C
2170,Chris Jefferies,2003,2004,1,G,F
2171,Othyus Jeffers,2010,2014,4,G,
2172,Al Jefferson,2005,2018,13,C,F
2173,Amile Jefferson,2019,2020,1,F,
2174,Cory Jefferson,2015,2016,1,F,
2175,Dontell Jefferson,2009,2009,0,G,
2176,Richard Jefferson,2002,2018,16,F,
2177,DaQuan Jeffries,2020,2022,2,G,F
2178,Jared Jeffries,2003,2013,10,F,
2179,Charles Jenkins,2012,2013,1,G,
2180,Horace Jenkins,2005,2005,0,G,
2181,John Jenkins,2013,2019,6,G,
2182,Brandon Jennings,2010,2018,8,G,
2183,Keith Jennings,1993,1995,2,G,
2184,Chris Jent,1994,1997,3,F,
2185,Les Jepsen,1991,1992,1,C,
2186,Jonas Jerebko,2010,2019,9,F,
2187,Ty Jerome,2020,2022,2,G,
2188,Grant Jerrett,2015,2015,0,F,
2189,Eugene Jeter,2011,2011,0,G,
2190,Hal Jeter,1970,1970,0,G,
2191,Yi Jianlian,2008,2012,4,F,
2192,Isaiah Joe,2021,2022,1,G,
2193,Britton Johnsen,2004,2005,1,F,
2194,Alexander Johnson,2007,2008,1,F,
2195,Alize Johnson,2019,2022,3,F,
2196,Amir Johnson,2006,2019,13,F,C
2197,Andy Johnson,1959,1962,3,F,G
2198,Anthony Johnson,1998,2010,12,G,
2199,Armon Johnson,2011,2012,1,G,
2200,Arnie Johnson,1949,1953,4,F,C
2201,Avery Johnson,1989,2004,15,G,
2202,B.J. Johnson,2019,2022,3,G,
2203,Brice Johnson,2017,2018,1,F,
2204,Buck Johnson,1987,1993,6,F,
2205,Cameron Johnson,2020,2022,2,F,
2206,Carldell Johnson,2012,2012,0,G,
2207,Charles Johnson,1973,1979,6,G,
2208,Cheese Johnson,1980,1980,0,F,G
2209,Chris Johnson,2011,2013,2,C,
2210,Chris Johnson,2013,2016,3,F,G
2211,Clay Johnson,1982,1984,2,G,
2212,Clemon Johnson,1979,1988,9,C,F
2213,Dakari Johnson,2018,2018,0,C,
2214,Darryl Johnson,1996,1996,0,G,
2215,Dave Johnson,1993,1994,1,G,F
2216,David Johnson,2022,2022,0,G,
2217,DeMarco Johnson,2000,2000,0,F,
2218,Dennis Johnson*,1977,1990,13,G,
2219,DerMarr Johnson,2001,2008,7,F,
2220,Ed Johnson,1969,1971,2,C,
2221,Eddie Johnson,1978,1987,9,G,
2222,Eddie Johnson,1982,1999,17,F,G
2223,Eric Johnson,1990,1990,0,G,
2224,Ervin Johnson,1994,2006,12,C,
2225,Frank Johnson,1982,1994,12,G,
2226,George Johnson,1971,1974,3,C,
2227,George Johnson,1973,1986,13,C,F
2228,George Johnson,1979,1986,7,F,C
2229,Gus Johnson*,1964,1973,9,F,C
2230,Harold Johnson,1947,1947,0,C,
2231,Ivan Johnson,2012,2013,1,F,
2232,JaJuan Johnson,2012,2012,0,F,
2233,Jalen Johnson,2022,2022,0,F,
2234,James Johnson,2010,2022,12,F,
2235,Joe Johnson,2002,2022,20,G,F
2236,John Johnson,1971,1982,11,F,
2237,Kannard Johnson,1988,1988,0,F,
2238,Keldon Johnson,2020,2022,2,G,
2239,Ken Johnson,1986,1986,0,F,
2240,Ken Johnson,2003,2003,0,F,C
2241,Keon Johnson,2022,2022,0,G,
2242,Kevin Johnson,1988,2000,12,G,
2243,Larry Johnson,1978,1978,0,G,
2244,Larry Johnson,1992,2001,9,F,
2245,Lee Johnson,1981,1981,0,F,
2246,Linton Johnson,2004,2009,5,F,
2247,Magic Johnson*,1980,1996,16,G,F
2248,Marques Johnson,1978,1990,12,F,G
2249,Mickey Johnson,1975,1986,11,F,
2250,Neil Johnson,1967,1973,6,F,C
2251,Nick Johnson,2015,2015,0,G,
2252,Ollie Johnson,1973,1982,9,F,
2253,Omari Johnson,2018,2018,0,F,
2254,Orlando Johnson,2013,2016,3,G,
2255,Ralph Johnson,1950,1953,3,G,
2256,Reggie Johnson,1981,1984,3,F,C
2257,Rich Johnson,1969,1971,2,C,
2258,Ron Johnson,1961,1961,0,F,
2259,Stanley Johnson,2016,2022,6,F,
2260,Steffond Johnson,1987,1987,0,F,
2261,Steve Johnson,1982,1991,9,C,F
2262,Stew Johnson,1968,1976,8,F,C
2263,Trey Johnson,2009,2012,3,G,
2264,Tyler Johnson,2015,2022,7,G,
2265,Vinnie Johnson,1980,1992,12,G,
2266,Wesley Johnson,2011,2019,8,F,G
2267,Darius Johnson-Odom,2013,2014,1,G,
2268,Nate Johnston,1990,1990,0,F,
2269,Neil Johnston*,1952,1959,7,C,
2270,Jim Johnstone,1983,1983,0,C,F
2271,Nikola Jokić,2016,2022,6,C,F
2272,Howie Jolliff,1961,1963,2,F,C
2273,Alvin Jones,2002,2002,0,C,
2274,Anthony Jones,1987,1990,3,G,F
2275,Askia Jones,1995,1995,0,G,
2276,Bill Jones,1989,1989,0,F,
2277,Bobby Jones*,1975,1986,11,F,
2278,Bobby Jones,2007,2008,1,F,
2279,Caldwell Jones,1974,1990,16,C,F
2280,Carlik Jones,2022,2022,0,G,
2281,Charles Jones,1984,1998,14,F,C
2282,Charles Jones,1985,1989,4,F,
2283,Charles Jones,1999,2000,1,G,
2284,Collis Jones,1972,1975,3,F,
2285,Dahntay Jones,2004,2017,13,G,F
2286,Damian Jones,2017,2022,5,F,C
2287,Damon Jones,1999,2009,10,G,
2288,DeQuan Jones,2013,2013,0,F,
2289,Derrick Jones Jr.,2017,2022,5,F,
2290,Dominique Jones,2011,2013,2,G,
2291,Dontae' Jones,1998,1998,0,F,
2292,Dwayne Jones,2006,2010,4,F,C
2293,Dwight Jones,1974,1983,9,F,C
2294,Earl Jones,1985,1986,1,C,
2295,Eddie Jones,1995,2008,13,G,F
2296,Edgar Jones,1981,1986,5,F,C
2297,Fred Jones,2003,2009,6,G,F
2298,Herbert Jones,2022,2022,0,F,
2299,Hutch Jones,1983,1984,1,F,
2300,Jake Jones,1972,1972,0,G,
2301,Jalen Jones,2018,2019,1,G,
2302,James Jones,2004,2017,13,F,G
2303,Jemerrio Jones,2019,2022,3,F,
2304,Jimmy Jones,1968,1977,9,G,
2305,Johnny Jones,1968,1969,1,F,
2306,Jumaine Jones,2000,2007,7,F,
2307,K.C. Jones*,1959,1967,8,G,
2308,Kai Jones,2022,2022,0,F,C
2309,Kevin Jones,2013,2013,0,F,
2310,Larry Jones,1965,1974,9,G,F
2311,Major Jones,1980,1985,5,F,
2312,Mark Jones,1984,1984,0,G,
2313,Mark Jones,2005,2005,0,G,
2314,Mason Jones,2021,2022,1,G,
2315,Nick Jones,1968,1973,5,G,
2316,Ozell Jones,1985,1986,1,C,F
2317,Perry Jones,2013,2015,2,F,
2318,Popeye Jones,1994,2004,10,F,
2319,Rich Jones,1970,1977,7,F,C
2320,Robin Jones,1977,1978,1,F,C
2321,Sam Jones*,1958,1969,11,G,F
2322,Shelton Jones,1989,1989,0,F,
2323,Solomon Jones,2007,2014,7,F,
2324,Steve Jones,1968,1976,8,G,F
2325,Terrence Jones,2013,2019,6,F,
2326,Tre Jones,2021,2022,1,G,
2327,Tyus Jones,2016,2022,6,G,
2328,Wah Wah Jones,1950,1952,2,F,
2329,Wali Jones,1965,1976,11,G,
2330,Wil Jones,1970,1978,8,F,
2331,Willie Jones,1961,1965,4,G,
2332,Adonis Jordan,1994,1999,5,G,
2333,Charles Jordan,1976,1976,0,F,
2334,DeAndre Jordan,2009,2022,13,C,
2335,Eddie Jordan,1978,1984,6,G,
2336,Jerome Jordan,2012,2015,3,C,
2337,Michael Jordan*,1985,2003,18,G,F
2338,Reggie Jordan,1994,2000,6,G,
2339,Thomas Jordan,1993,1993,0,F,C
2340,Walter Jordan,1981,1981,0,F,
2341,Phil Jordon,1957,1963,6,C,F
2342,Johnny Jorgensen,1948,1949,1,G,F
2343,Noble Jorgensen,1947,1953,6,C,
2344,Roger Jorgensen,1947,1947,0,C,F
2345,Cory Joseph,2012,2022,10,G,
2346,Garth Joseph,2001,2001,0,C,
2347,Kris Joseph,2013,2013,0,F,
2348,Yvon Joseph,1986,1986,0,C,
2349,Kevin Joyce,1974,1976,2,G,
2350,Butch Joyner,1969,1969,0,F,
2351,Jeff Judkins,1979,1983,4,G,F
2352,Mfiondu Kabengele,2020,2021,1,F,
2353,Whitey Kachan,1949,1949,0,G,
2354,George Kaftan,1949,1953,4,F,
2355,Ed Kalafat,1955,1957,2,C,F
2356,Georgios Kalaitzakis,2022,2022,0,G,F
2357,Chris Kaman,2004,2016,12,C,
2358,Frank Kaminsky,2016,2022,6,F,C
2359,Ralph Kaplowitz,1947,1948,1,G,F
2360,Jason Kapono,2004,2012,8,F,
2361,Tony Kappen,1947,1947,0,G,
2362,Sergey Karasev,2014,2016,2,G,F
2363,Coby Karl,2008,2010,2,G,
2364,George Karl,1974,1978,4,G,
2365,Ed Kasid,1947,1947,0,G,
2366,Mario Kasun,2005,2006,1,C,
2367,Leo Katkaveck,1949,1950,1,G,
2368,Bob Kauffman,1969,1975,6,F,C
2369,Sasha Kaun,2016,2016,0,C,
2370,Wilbert Kautz,1947,1947,0,G,F
2371,Clarence Kea,1981,1982,1,F,
2372,Mike Kearns,1955,1955,0,G,
2373,Tommy Kearns,1959,1959,0,G,
2374,Adam Keefe,1993,2001,8,F,
2375,Harold Keeling,1986,1986,0,G,
2376,Bill Keller,1970,1976,6,G,
2377,Gary Keller,1968,1969,1,F,C
2378,Ken Keller,1947,1947,0,G,
2379,Rich Kelley,1976,1986,10,C,F
2380,Clark Kellogg,1983,1987,4,F,
2381,Arvesta Kelly,1968,1972,4,G,
2382,Jerry Kelly,1947,1948,1,F,
2383,Ryan Kelly,2014,2017,3,F,
2384,Tom Kelly,1949,1949,0,G,
2385,Greg Kelser,1980,1985,5,F,
2386,Ben Kelso,1974,1974,0,G,
2387,Shawn Kemp,1990,2003,13,F,C
2388,Tim Kempton,1987,1998,11,F,C
2389,Frank Kendrick,1975,1975,0,F,
2390,Luke Kennard,2018,2022,4,G,
2391,D.J. Kennedy,2012,2012,0,F,
2392,Goo Kennedy,1972,1977,5,F,C
2393,Joe Kennedy,1969,1971,2,F,
2394,Pickles Kennedy,1961,1961,0,G,
2395,Larry Kenon,1974,1983,9,F,
2396,Billy Kenville,1954,1960,6,G,F
2397,Jonathan Kerner,1999,1999,0,C,
2398,Red Kerr,1955,1966,11,C,F
2399,Steve Kerr,1989,2003,14,G,
2400,Jack Kerris,1950,1953,3,F,C
2401,Jerome Kersey,1985,2001,16,F,
2402,Tom Kerwin,1968,1968,0,F,
2403,Alec Kessler,1991,1994,3,F,C
2404,Lari Ketner,2000,2001,1,F,C
2405,Braxton Key,2022,2022,0,F,
2406,Julius Keye,1970,1975,5,F,C
2407,Randolph Keys,1989,1996,7,F,G
2408,Viktor Khryapa,2005,2008,3,F,
2409,Jason Kidd*,1995,2013,18,G,
2410,Stanton Kidd,2020,2020,0,F,
2411,Warren Kidd,1994,1994,0,F,
2412,Michael Kidd-Gilchrist,2013,2020,7,F,
2413,Irv Kiffin,1980,1980,0,F,
2414,Jack Kiley,1952,1953,1,G,
2415,Earnie Killum,1971,1971,0,G,
2416,Carl Kilpatrick,1980,1980,0,C,
2417,Sean Kilpatrick,2015,2018,3,G,
2418,Toby Kimball,1967,1975,8,F,C
2419,Bo Kimble,1991,1993,2,G,
2420,Stan Kimbrough,1990,1993,3,G,
2421,Chad Kinch,1981,1981,0,G,
2422,Albert King,1982,1992,10,F,G
2423,Bernard King*,1978,1993,15,F,
2424,Chris King,1994,1999,5,F,
2425,Dan King,1955,1955,0,F,
2426,Frankie King,1996,1997,1,G,
2427,George King,1952,1958,6,G,
2428,George King,2019,2022,3,G,F
2429,Gerard King,1999,2001,2,F,
2430,Jim King,1964,1973,9,G,
2431,Jimmy King,1996,1997,1,G,
2432,Louis King,2020,2022,2,F,
2433,Loyd King,1972,1973,1,G,
2434,Maurice King,1960,1963,3,G,
2435,Reggie King,1980,1985,5,F,
2436,Rich King,1992,1995,3,C,
2437,Ron King,1974,1974,0,G,
2438,Stacey King,1990,1997,7,F,C
2439,Tom King,1947,1947,0,G,
2440,Bob Kinney,1949,1950,1,C,F
2441,Tarence Kinsey,2007,2009,2,G,
2442,Andrei Kirilenko,2002,2015,13,F,
2443,Alex Kirk,2015,2015,0,C,
2444,Walt Kirk,1949,1952,3,G,F
2445,Wilbur Kirkland,1970,1970,0,F,
2446,Corey Kispert,2022,2022,0,G,F
2447,Jim Kissane,1969,1969,0,F,
2448,Doug Kistler,1962,1962,0,F,
2449,Curtis Kitchen,1987,1987,0,F,
2450,Greg Kite,1984,1995,11,C,
2451,Kerry Kittles,1997,2005,8,G,
2452,Maxi Kleber,2018,2022,4,F,
2453,Joe Kleine,1986,2000,14,C,
2454,Linas Kleiza,2006,2013,7,F,
2455,Leo Klier,1949,1950,1,F,G
2456,Herm Klotz,1948,1948,0,G,
2457,Duane Klueh,1950,1951,1,G,
2458,Lonnie Kluttz,1971,1971,0,F,
2459,Billy Knight,1975,1985,10,G,F
2460,Bob Knight,1955,1955,0,G,F
2461,Brandin Knight,2005,2005,0,G,
2462,Brandon Knight,2012,2022,10,G,
2463,Brevin Knight,1998,2009,11,G,
2464,Nathan Knight,2021,2022,1,F,C
2465,Negele Knight,1991,1999,8,G,
2466,Ron Knight,1971,1972,1,F,
2467,Toby Knight,1978,1982,4,F,
2468,Travis Knight,1997,2003,6,C,
2469,Lee Knorek,1947,1950,3,C,
2470,Dick Knostman,1954,1954,0,C,
2471,Rod Knowles,1969,1969,0,F,C
2472,Kevin Knox,2019,2022,3,F,
2473,Bart Kofoed,1988,1993,5,G,
2474,Don Kojis,1964,1975,11,F,
2475,Milo Komenich,1950,1950,0,F,C
2476,Howard Komives,1965,1974,9,G,
2477,Jon Koncak,1986,1996,10,C,F
2478,John Konchar,2020,2022,2,G,
2479,Tom Kondla,1969,1969,0,C,
2480,Bud Koper,1965,1965,0,G,
2481,Joe Kopicki,1983,1985,2,F,
2482,Furkan Korkmaz,2018,2022,4,G,
2483,Frank Kornet,1990,1991,1,F,
2484,Luke Kornet,2018,2022,4,F,
2485,Yaroslav Korolev,2006,2007,1,F,
2486,Kyle Korver,2004,2020,16,G,F
2487,Tony Koski,1969,1969,0,F,
2488,Len Kosmalski,1975,1976,1,C,
2489,Andy Kostecka,1949,1949,0,F,
2490,Harold Kottman,1947,1947,0,C,
2491,Kosta Koufos,2009,2019,10,C,
2492,Tom Kozelko,1974,1976,2,F,
2493,Ronald Kozlicki,1968,1968,0,F,
2494,Arvid Kramer,1980,1980,0,C,
2495,Barry Kramer,1965,1970,5,F,G
2496,Joel Kramer,1979,1983,4,F,C
2497,Steven Kramer,1968,1970,2,G,F
2498,Dan Kraus,1949,1949,0,G,
2499,Herb Krautblatt,1949,1949,0,G,
2500,Viacheslav Kravtsov,2013,2014,1,C,
2501,Jim Krebs,1958,1964,6,C,F
2502,Vit Krejci,2022,2022,0,G,
2503,Wayne Kreklow,1981,1981,0,G,
2504,Tommy Kron,1967,1970,3,G,
2505,Tom Kropp,1976,1977,1,G,
2506,Nenad Krstić,2005,2011,6,C,
2507,Larry Krystkowiak,1987,1997,10,F,C
2508,Steve Kuberski,1970,1978,8,F,C
2509,Leo Kubiak,1950,1950,0,G,
2510,Bruce Kuczenski,1984,1984,0,F,
2511,Frank Kudelka,1950,1953,3,G,F
2512,John Kuester,1978,1980,2,G,
2513,Ray Kuka,1948,1949,1,F,
2514,Toni Kukoč*,1994,2006,12,F,
2515,Arnoldas Kulboka,2022,2022,0,F,
2516,Jonathan Kuminga,2022,2022,0,F,
2517,Kevin Kunnert,1974,1982,8,C,F
2518,Terry Kunze,1968,1968,0,G,F
2519,Mitch Kupchak,1977,1986,9,F,C
2520,C.J. Kupec,1976,1978,2,F,C
2521,Rodions Kurucs,2019,2021,2,F,
2522,Rob Kurz,2009,2009,0,F,
2523,Ibo Kutluay,2005,2005,0,G,
2524,Kyle Kuzma,2018,2022,4,F,
2525,Ognjen Kuzmić,2014,2015,1,C,
2526,Mindaugas Kuzminskas,2017,2018,1,F,
2527,Fred LaCour,1961,1963,2,G,F
2528,Raef LaFrentz,1999,2008,9,F,C
2529,Tom LaGarde,1978,1985,7,C,F
2530,Rusty LaRue,1998,2004,6,G,
2531,Rudy LaRusso,1960,1969,9,F,C
2532,Zach LaVine,2015,2022,7,G,F
2533,Skal Labissière,2017,2020,3,F,
2534,Reggie Lacefield,1969,1969,0,G,F
2535,Edgar Lacey,1969,1969,0,F,
2536,Sam Lacey,1971,1983,12,C,
2537,Bob Lackey,1973,1974,1,G,F
2538,Wendell Ladner,1971,1975,4,F,
2539,Christian Laettner,1993,2005,12,F,C
2540,Oliver Lafayette,2010,2010,0,G,
2541,Bill Laimbeer,1981,1994,13,C,
2542,Pete Lalich,1947,1947,0,F,
2543,Bo Lamar,1974,1977,3,G,
2544,Anthony Lamb,2021,2022,1,F,
2545,Doron Lamb,2013,2014,1,G,
2546,Jeremy Lamb,2013,2022,9,G,F
2547,John Lambert,1976,1982,6,C,F
2548,Jeff Lamp,1982,1989,7,F,G
2549,Maciej Lampe,2004,2006,2,C,
2550,Jim Lampley,1987,1987,0,C,
2551,Sean Lampley,2003,2004,1,F,
2552,Jock Landale,2022,2022,0,C,
2553,Carl Landry,2008,2016,8,F,
2554,Marcus Landry,2010,2010,0,F,
2555,Mark Landsberger,1978,1984,6,F,C
2556,Jerome Lane,1989,1993,4,F,
2557,Andrew Lang,1989,2000,11,C,
2558,Antonio Lang,1995,2000,5,F,G
2559,James Lang,2007,2007,0,C,
2560,Trajan Langdon,2000,2002,2,G,
2561,Keith Langford,2008,2008,0,G,
2562,Romeo Langford,2020,2022,2,G,
2563,Dan Langhi,2001,2004,3,F,
2564,Bob Lanier*,1971,1984,13,C,
2565,Stu Lantz,1969,1976,7,G,
2566,Nicolás Laprovíttola,2017,2017,0,G,
2567,York Larese,1962,1962,0,G,
2568,Shane Larkin,2014,2018,4,G,
2569,John Laskowski,1976,1977,1,G,
2570,Stéphane Lasme,2008,2008,0,F,
2571,Dave Lattin,1968,1973,5,F,C
2572,Priest Lauderdale,1997,1998,1,C,
2573,Rich Laurel,1978,1978,0,G,
2574,Harry Laurie,1971,1971,0,G,
2575,Walt Lautenbach,1950,1950,0,G,F
2576,Joffrey Lauvergne,2015,2018,3,C,F
2577,Tony Lavelli,1950,1951,1,F,
2578,Bob Lavoy,1951,1954,3,F,C
2579,Acie Law,2008,2011,3,G,
2580,Vic Law,2020,2020,0,F,
2581,Gani Lawal,2011,2011,0,F,
2582,Edmund Lawrence,1981,1981,0,C,
2583,Jason Lawson,1998,1998,0,C,
2584,Ty Lawson,2010,2017,7,G,
2585,Jake Layman,2017,2022,5,F,
2586,Mo Layton,1972,1978,6,G,
2587,Caris LeVert,2017,2022,5,G,F
2588,T.J. Leaf,2018,2021,3,F,
2589,Manny Leaks,1969,1974,5,C,F
2590,Hal Lear,1957,1957,0,G,
2591,Allen Leavell,1980,1989,9,G,
2592,Jeff Lebo,1990,1990,0,G,
2593,Eric Leckner,1989,1997,8,C,F
2594,Jalen Lecque,2020,2021,1,G,
2595,Ricky Ledo,2014,2015,1,G,
2596,Butch Lee,1979,1980,1,G,
2597,Clyde Lee,1967,1976,9,F,C
2598,Courtney Lee,2009,2020,11,G,
2599,Damion Lee,2018,2022,4,G,
2600,David Lee,1968,1969,1,F,
2601,David Lee,2006,2017,11,F,
2602,Dick Lee,1968,1968,0,F,
2603,Doug Lee,1992,1995,3,G,F
2604,George Lee,1961,1968,7,F,G
2605,Greg Lee,1975,1976,1,G,
2606,Keith Lee,1986,1989,3,F,C
2607,Kurk Lee,1991,1991,0,G,
2608,Malcolm Lee,2012,2015,3,G,
2609,Rock Lee,1982,1982,0,C,
2610,Ron Lee,1977,1982,5,G,
2611,Russ Lee,1973,1975,2,G,F
2612,Saben Lee,2021,2022,1,G,
2613,Ed Leede,1950,1951,1,F,G
2614,Hank Lefkowitz,1947,1947,0,F,
2615,Tim Legler,1990,2000,10,G,
2616,George Lehmann,1968,1974,6,G,
2617,Barry Leibowitz,1968,1968,0,G,
2618,Walt Lemon Jr.,2018,2019,1,G,
2619,Alex Len,2014,2022,8,C,
2620,Voshon Lenard,1996,2006,10,G,
2621,Leary Lentz,1968,1969,1,F,
2622,Gary Leonard,1990,1992,2,C,
2623,Kawhi Leonard,2012,2021,9,F,
2624,Meyers Leonard,2013,2021,8,C,F
2625,Slick Leonard*,1957,1963,6,G,
2626,Jim Les,1989,1995,6,G,
2627,Travis Leslie,2012,2012,0,G,
2628,Ronnie Lester,1981,1986,5,G,
2629,Clifford Lett,1990,1991,1,G,
2630,Jon Leuer,2012,2019,7,F,
2631,Andrew Levane,1949,1953,4,F,G
2632,Fat Lever,1983,1994,11,G,
2633,Cliff Levingston,1983,1995,12,F,
2634,Bobby Lewis,1968,1971,3,G,
2635,Cedric Lewis,1996,1996,0,F,C
2636,Freddie Lewis,1949,1950,1,F,G
2637,Freddie Lewis,1967,1977,10,G,
2638,Grady Lewis,1947,1949,2,F,C
2639,Kira Lewis Jr.,2021,2022,1,G,
2640,Martin Lewis,1996,1997,1,F,
2641,Mike Lewis,1969,1974,5,C,F
2642,Quincy Lewis,2000,2004,4,F,
2643,Ralph Lewis,1988,1990,2,F,G
2644,Rashard Lewis,1999,2014,15,F,
2645,Reggie Lewis,1988,1993,5,G,F
2646,Scottie Lewis,2022,2022,0,G,
2647,Marcus Liberty,1991,1994,3,F,
2648,Todd Lichti,1990,1994,4,G,F
2649,DeAndre Liggins,2012,2018,6,G,
2650,Bill Ligon,1975,1975,0,G,
2651,Goose Ligon,1968,1974,6,F,C
2652,Damian Lillard,2013,2022,9,G,
2653,Jeremy Lin,2011,2019,8,G,
2654,Steve Lingenfelter,1983,1984,1,F,
2655,Alton Lister,1982,1998,16,C,F
2656,Nassir Little,2020,2022,2,F,
2657,Samuel Little,1970,1970,0,G,
2658,Gene Littles,1970,1975,5,G,
2659,Isaiah Livers,2022,2022,0,F,
2660,Randy Livingston,1997,2007,10,G,
2661,Shaun Livingston,2005,2019,14,G,
2662,Ron Livingstone,1950,1951,1,C,
2663,Horacio Llamas,1997,1998,1,C,
2664,Bobby Lloyd,1968,1969,1,G,
2665,Chuck Lloyd,1971,1971,0,C,F
2666,Earl Lloyd*,1951,1960,9,F,C
2667,Lewis Lloyd,1982,1990,8,G,F
2668,Scott Lloyd,1977,1983,6,C,F
2669,Riney Lochmann,1968,1970,2,F,
2670,Bob Lochmueller,1953,1953,0,F,
2671,Rob Lock,1989,1989,0,F,
2672,Darrell Lockhart,1984,1984,0,C,
2673,Ian Lockhart,1991,1991,0,F,
2674,Kevin Loder,1982,1984,2,F,G
2675,Don Lofgran,1951,1954,3,F,C
2676,Zach Lofton,2019,2019,0,G,
2677,Henry Logan,1969,1970,1,G,
2678,John Logan,1947,1951,4,G,
2679,Brad Lohaus,1988,1998,10,F,C
2680,Art Long,2001,2003,2,F,C
2681,Grant Long,1989,2003,14,F,
2682,John Long,1979,1997,18,G,F
2683,Paul Long,1968,1971,3,G,
2684,Shawn Long,2017,2017,0,C,F
2685,Willie Long,1972,1974,2,F,C
2686,Luc Longley,1992,2001,9,C,
2687,Kevon Looney,2016,2022,6,F,C
2688,Brook Lopez,2009,2022,13,C,
2689,Felipe López,1999,2002,3,G,
2690,Raül López,2004,2005,1,G,
2691,Robin Lopez,2009,2022,13,C,
2692,Ryan Lorthridge,1995,1995,0,G,
2693,Jim Loscutoff,1956,1964,8,F,
2694,Plummer Lott,1968,1969,1,F,G
2695,Kevin Loughery,1963,1973,10,G,
2696,Didi Louzada,2021,2022,1,G,
2697,Bob Love,1967,1977,10,F,
2698,Kevin Love,2009,2022,13,F,
2699,Stan Love,1972,1975,3,F,
2700,Clyde Lovellette*,1954,1964,10,C,F
2701,Sidney Lowe,1984,1990,6,G,
2702,Charlie Lowery,1972,1972,0,G,
2703,Kyle Lowry,2007,2022,15,G,
2704,Jordan Loyd,2019,2019,0,G,
2705,Al Lucas,1949,1949,0,F,G
2706,Jerry Lucas*,1964,1974,10,F,C
2707,John Lucas,1977,1990,13,G,
2708,Kalin Lucas,2015,2019,4,G,
2709,Maurice Lucas,1975,1988,13,F,C
2710,John Lucas III,2006,2017,11,G,
2711,Ted Luckenbill,1962,1963,1,F,
2712,Tyronn Lue,1999,2009,10,G,
2713,Jim Luisi,1954,1954,0,G,
2714,Al Lujack,1947,1947,0,F,
2715,Phil Lumpkin,1975,1976,1,G,
2716,Ray Lumpp,1949,1953,4,G,
2717,Timothé Luwawu-Cabarrot,2017,2022,5,F,
2718,Tyler Lydon,2018,2019,1,F,
2719,Trey Lyles,2016,2022,6,F,
2720,R.B. Lynam,1968,1968,0,G,
2721,George Lynch,1994,2005,11,F,
2722,Kevin Lynch,1992,1993,1,G,F
2723,Lonnie Lynn,1970,1970,0,F,
2724,Mike Lynn,1970,1971,1,F,
2725,Sheldon Mac,2017,2017,0,G,
2726,Todd MacCulloch,2000,2003,3,C,
2727,Ronnie MacGilvray,1955,1955,0,G,
2728,Don MacLean,1993,2001,8,F,
2729,Mike Macaluso,1974,1974,0,F,
2730,Ed Macauley*,1950,1959,9,C,F
2731,Scott Machado,2013,2019,6,G,
2732,Arvydas Macijauskas,2006,2006,0,G,
2733,Ollie Mack,1980,1982,2,G,
2734,Sam Mack,1993,2002,9,F,G
2735,Shelvin Mack,2012,2019,7,G,
2736,Malcolm Mackey,1994,1994,0,F,C
2737,Rudy Macklin,1982,1984,2,F,G
2738,Vernon Macklin,2012,2012,0,F,
2739,Johnny Macknowski,1950,1951,1,G,F
2740,Daryl Macon,2019,2020,1,G,
2741,Mark Macon,1992,1999,7,G,
2742,J.P. Macura,2019,2020,1,G,
2743,Kyle Macy,1981,1987,6,G,
2744,Jack Maddox,1949,1949,0,F,G
2745,Tito Maddox,2003,2003,0,G,
2746,Gerald Madkins,1994,1998,4,G,
2747,Mark Madsen,2001,2009,8,F,
2748,Norm Mager,1951,1951,0,F,
2749,Josh Magette,2018,2020,2,G,
2750,Corey Maggette,2000,2013,13,F,
2751,Dave Magley,1983,1983,0,F,
2752,Jamaal Magloire,2001,2012,11,C,
2753,Will Magnay,2021,2021,0,C,
2754,Randolph Mahaffey,1968,1971,3,F,
2755,Ian Mahinmi,2008,2020,12,C,
2756,John Mahnken,1947,1953,6,C,
2757,Brian Mahoney,1973,1973,0,G,
2758,Mo Mahoney,1953,1954,1,F,
2759,Rick Mahorn,1981,1999,18,C,F
2760,Dan Majerle,1989,2002,13,G,F
2761,Renaldo Major,2007,2007,0,F,
2762,Thon Maker,2017,2021,4,F,C
2763,Lionel Malamed,1949,1949,0,G,
2764,Théo Maledon,2021,2022,1,G,
2765,Jeff Malone,1984,1996,12,G,
2766,Karl Malone*,1986,2004,18,F,
2767,Moses Malone*,1975,1995,20,C,F
2768,Matt Maloney,1997,2003,6,G,
2769,Steve Malovic,1980,1980,0,F,
2770,Mike Maloy,1971,1973,2,F,
2771,Sandro Mamukelashvili,2022,2022,0,F,
2772,Ted Manakas,1974,1974,0,G,
2773,John Mandic,1949,1950,1,F,C
2774,Karim Mané,2021,2021,0,G,
2775,Frank Mangiapane,1947,1947,0,G,
2776,Terance Mann,2020,2022,2,G,F
2777,Tre Mann,2022,2022,0,G,
2778,Danny Manning,1989,2003,14,F,C
2779,Ed Manning,1968,1976,8,F,
2780,Guy Manning,1968,1969,1,F,
2781,Rich Manning,1996,1997,1,C,
2782,Nico Mannion,2021,2021,0,G,
2783,Pace Mannion,1984,1989,5,G,
2784,Nick Mantis,1960,1963,3,G,
2785,Pete Maravich*,1971,1980,9,G,
2786,Press Maravich,1947,1947,0,G,
2787,Devyn Marble,2015,2016,1,G,F
2788,Roy Marble,1990,1994,4,G,F
2789,Stephon Marbury,1997,2009,12,G,
2790,Šarūnas Marčiulionis*,1990,1997,7,G,
2791,Saul Mariaschin,1948,1948,0,G,
2792,Jack Marin,1967,1977,10,F,G
2793,Shawn Marion,2000,2015,15,F,
2794,Boban Marjanović,2016,2022,6,C,
2795,Lauri Markkanen,2018,2022,4,F,C
2796,Damir Markota,2007,2007,0,C,
2797,Sean Marks,1999,2011,12,F,C
2798,Harvey Marlatt,1971,1973,2,G,
2799,Jim Marsh,1972,1972,0,F,
2800,Ricky Marsh,1978,1978,0,G,
2801,Donny Marshall,1996,2003,7,F,
2802,Donyell Marshall,1995,2009,14,F,
2803,Kendall Marshall,2013,2016,3,G,
2804,Naji Marshall,2021,2022,1,F,
2805,Rawle Marshall,2006,2007,1,G,F
2806,Tom Marshall,1955,1959,4,F,G
2807,Vester Marshall,1974,1974,0,F,
2808,Bill Martin,1986,1988,2,F,
2809,Bob Martin,1994,1995,1,C,
2810,Brian Martin,1986,1986,0,F,
2811,Caleb Martin,2020,2022,2,F,
2812,Cartier Martin,2009,2015,6,F,
2813,Cody Martin,2020,2022,2,G,F
2814,Cuonzo Martin,1996,1997,1,G,F
2815,Darrick Martin,1995,2008,13,G,
2816,Dino Martin,1947,1948,1,G,
2817,Don Martin,1947,1949,2,C,F
2818,Fernando Martín,1987,1987,0,C,
2819,Jarell Martin,2016,2019,3,F,
2820,Jeff Martin,1990,1991,1,G,
2821,Jeremiah Martin,2020,2021,1,G,
2822,Kelan Martin,2020,2022,2,F,
2823,Kenyon Martin,2001,2015,14,F,
2824,Kenyon Martin Jr.,2021,2022,1,F,
2825,Kevin Martin,2005,2016,11,G,
2826,LaRue Martin,1973,1976,3,C,
2827,Maurice Martin,1987,1988,1,F,G
2828,Phil Martin,1955,1955,0,G,
2829,Slater Martin*,1950,1960,10,G,
2830,Whitey Martin,1962,1962,0,G,
2831,Jamal Mashburn,1994,2004,10,F,
2832,Al Masino,1953,1954,1,G,
2833,Anthony Mason,1990,2003,13,F,
2834,Desmond Mason,2001,2010,9,F,
2835,Frank Mason III,2018,2021,3,G,
2836,Roger Mason,2003,2014,11,G,
2837,Tony Massenburg,1991,2005,14,F,
2838,Eddie Mast,1971,1973,2,F,C
2839,Yante Maten,2019,2019,0,F,
2840,Garrison Mathews,2020,2022,2,G,
2841,Mangok Mathiang,2018,2018,0,C,F
2842,Dakota Mathias,2021,2022,1,G,
2843,Johnny Mathis,1968,1968,0,F,
2844,Wes Matthews,1981,1990,9,G,
2845,Wesley Matthews,2010,2022,12,G,
2846,Ariel Maughan,1947,1951,4,F,
2847,Marlon Maxey,1993,1994,1,F,
2848,Tyrese Maxey,2021,2022,1,G,
2849,Jason Maxiell,2006,2015,9,F,
2850,Cedric Maxwell,1978,1988,10,F,
2851,Vernon Maxwell,1989,2001,12,G,
2852,Don May,1969,1975,6,F,
2853,Scott May,1977,1983,6,F,
2854,Sean May,2006,2010,4,F,
2855,Lee Mayberry,1993,1999,6,G,
2856,Clyde Mayes,1976,1977,1,F,
2857,Tharon Mayes,1992,1992,0,G,
2858,Bill Mayfield,1981,1981,0,F,
2859,Ken Mayfield,1976,1976,0,G,
2860,Eric Maynor,2010,2014,4,G,
2861,O.J. Mayo,2009,2016,7,G,
2862,Skylar Mays,2021,2022,1,G,
2863,Travis Mays,1991,1993,2,G,
2864,Matt Mazza,1950,1950,0,F,
2865,Luc Mbah a Moute,2009,2020,11,F,
2866,Bob McAdoo*,1973,1986,13,C,F
2867,James Michael McAdoo,2015,2018,3,F,
2868,Ken McBride,1955,1955,0,G,F
2869,Miles McBride,2022,2022,0,G,
2870,Tahjere McCall,2019,2019,0,G,
2871,Ray McCallum,2014,2016,2,G,
2872,Bob McCann,1990,1998,8,F,
2873,Brendan McCann,1958,1960,2,G,
2874,Mel McCants,1990,1990,0,F,
2875,Rashad McCants,2006,2009,3,G,
2876,Mike McCarron,1947,1950,3,G,
2877,Andre McCarter,1977,1981,4,G,
2878,Willie McCarter,1970,1972,2,G,
2879,Johnny McCarthy,1957,1964,7,G,
2880,Howie McCarty,1947,1947,0,F,G
2881,Kelly McCarty,1999,1999,0,G,F
2882,Walter McCarty,1997,2006,9,F,
2883,Amal McCaskill,1997,2004,7,F,C
2884,Patrick McCaw,2017,2021,4,G,
2885,Dwayne McClain,1986,1986,0,G,
2886,Ted McClain,1972,1979,7,G,
2887,Dan McClintock,2001,2001,0,C,
2888,Jack McCloskey,1953,1953,0,G,
2889,George McCloud,1990,2002,12,G,F
2890,Mac McClung,2022,2022,0,G,
2891,CJ McCollum,2014,2022,8,G,
2892,John McConathy,1952,1952,0,F,
2893,Bucky McConnell,1953,1953,0,G,
2894,T.J. McConnell,2016,2022,6,G,
2895,Keith McCord,1981,1981,0,G,
2896,Tim McCormick,1985,1992,7,C,
2897,Jelani McCoy,1999,2008,9,C,
2898,Paul McCracken,1973,1977,4,G,
2899,Chris McCray,2007,2007,0,G,
2900,Rodney McCray,1984,1993,9,F,G
2901,Scooter McCray,1984,1987,3,F,G
2902,Erik McCree,2018,2018,0,F,
2903,Chris McCullough,2016,2018,2,F,
2904,John McCullough,1982,1982,0,G,
2905,Clint McDaniel,1996,1996,0,G,
2906,Xavier McDaniel,1986,1998,12,F,
2907,Jaden McDaniels,2021,2022,1,F,
2908,Jalen McDaniels,2020,2022,2,F,
2909,Jim McDaniels,1972,1978,6,C,F
2910,K.J. McDaniels,2015,2017,2,G,F
2911,Doug McDermott,2015,2022,7,F,
2912,Sean McDermott,2021,2021,0,F,
2913,Ben McDonald,1986,1989,3,F,
2914,Glenn McDonald,1975,1977,2,F,G
2915,Michael McDonald,1998,1998,0,C,
2916,Roderick McDonald,1971,1973,2,F,
2917,Hank McDowell,1982,1987,5,F,C
2918,Antonio McDyess,1996,2011,15,F,C
2919,Jim McElroy,1976,1982,6,G,
2920,Patrick McFarland,1974,1976,2,F,G
2921,Ivan McFarlin,2007,2007,0,F,
2922,Mel McGaha,1949,1949,0,G,
2923,Mitch McGary,2015,2016,1,F,C
2924,JaVale McGee,2009,2022,13,C,
2925,Mike McGee,1982,1990,8,G,F
2926,Bill McGill,1963,1970,7,C,F
2927,George McGinnis*,1972,1982,10,F,C
2928,Jon McGlocklin,1966,1976,10,G,F
2929,Tracy McGrady*,1998,2012,14,F,G
2930,Gil McGregor,1972,1972,0,F,
2931,Cameron McGriff,2022,2022,0,F,
2932,Elton McGriff,1968,1969,1,C,
2933,Rodney McGruder,2017,2022,5,G,
2934,Alfred McGuire*,1952,1955,3,G,F
2935,Allie McGuire,1974,1974,0,G,
2936,Dick McGuire*,1950,1960,10,G,
2937,Dominic McGuire,2008,2013,5,F,
2938,Kevin McHale*,1981,1993,12,F,C
2939,Maurice McHartley,1968,1970,2,G,F
2940,Jim McIlvaine,1995,2001,6,C,
2941,Jeff McInnis,1997,2008,11,G,
2942,Kenny McIntosh,1972,1975,3,F,
2943,Bob McIntyre,1968,1970,2,F,
2944,Jerry McKee,1970,1970,0,G,
2945,Kevin McKenna,1982,1988,6,G,F
2946,Forrest McKenzie,1987,1987,0,F,
2947,Stan McKenzie,1968,1974,6,F,G
2948,Derrick McKey,1988,2002,14,F,C
2949,Aaron McKie,1995,2007,12,G,
2950,Billy McKinney,1979,1986,7,G,
2951,Bones McKinney,1947,1952,5,F,C
2952,Carlton McKinney,1990,1992,2,G,
2953,Trey McKinney-Jones,2018,2018,0,G,
2954,Alfonzo McKinnie,2018,2022,4,F,
2955,JaQuori McLaughlin,2022,2022,0,G,
2956,Jordan McLaughlin,2020,2022,2,G,
2957,Ben McLemore,2014,2022,8,G,
2958,McCoy McLemore,1965,1972,7,F,C
2959,George McLeod,1953,1953,0,F,
2960,Keith McLeod,2004,2007,3,G,
2961,Roshown McLeod,1999,2001,2,F,
2962,Jack McMahon,1953,1960,7,G,
2963,Nate McMillan,1987,1998,11,G,F
2964,Tom McMillen,1976,1986,10,F,C
2965,Jim McMillian,1971,1979,8,F,
2966,Shellie McMillon,1959,1962,3,F,
2967,Mal McMullen,1950,1951,1,F,C
2968,Chet McNabb,1948,1948,0,F,
2969,Mark McNamara,1983,1991,8,C,F
2970,Joe McNamee,1951,1952,1,F,C
2971,Jerel McNeal,2015,2015,0,G,
2972,Chris McNealy,1986,1988,2,F,
2973,Bob McNeill,1961,1962,1,G,
2974,Larry McNeill,1974,1979,5,F,C
2975,Carl McNulty,1955,1955,0,G,
2976,Paul McPherson,2001,2001,0,G,
2977,Roy McPipe,1975,1975,0,G,
2978,Cozell McQueen,1987,1987,0,F,
2979,Jordan McRae,2016,2020,4,G,
2980,Thales McReynolds,1966,1966,0,G,
2981,Josh McRoberts,2008,2018,10,F,
2982,Eric McWilliams,1973,1973,0,F,
2983,George Mearns,1947,1948,1,F,
2984,Stanislav Medvedenko,2001,2007,6,F,
2985,Darnell Mee,1994,1995,1,G,
2986,Jodie Meeks,2010,2019,9,G,
2987,Cliff Meely,1972,1976,4,F,C
2988,Scott Meents,1990,1991,1,F,
2989,Dick Mehen,1950,1952,2,F,C
2990,Monk Meineke,1953,1958,5,F,C
2991,Carl Meinhold,1948,1949,1,G,F
2992,Salah Mejri,2016,2019,3,C,
2993,Gal Mekel,2014,2015,1,G,
2994,Bill Melchionni,1967,1976,9,G,
2995,Gary Melchionni,1974,1975,1,G,
2996,Nicolò Melli,2020,2021,1,F,
2997,Fab Melo,2013,2013,0,C,
2998,De'Anthony Melton,2019,2022,3,G,
2999,Ed Melvin,1947,1947,0,G,
3000,Dean Meminger,1972,1977,5,G,
3001,Chuck Mencel,1956,1957,1,G,
3002,John Mengelt,1972,1981,9,G,
3003,Ken Menke,1950,1950,0,G,
3004,Pops Mensah-Bonsu,2007,2011,4,F,
3005,Dewitt Menyard,1968,1968,0,C,
3006,Ron Mercer,1998,2005,7,G,F
3007,Joe Meriweather,1976,1985,9,C,F
3008,Porter Meriwether,1963,1963,0,G,
3009,Sam Merrill,2021,2022,1,G,
3010,Tom Meschery,1962,1971,9,F,
3011,Chimezie Metu,2019,2022,3,F,
3012,Bill Meyer,1968,1968,0,G,
3013,Loren Meyer,1996,1999,3,C,
3014,Dave Meyers,1976,1980,4,F,C
3015,Stan Miasek,1947,1953,6,C,F
3016,Larry Micheaux,1984,1985,1,F,
3017,Jordan Mickey,2016,2018,2,F,
3018,Khris Middleton,2013,2022,9,F,G
3019,Red Mihalik,1947,1947,0,G,
3020,Chris Mihm,2001,2009,8,C,
3021,Eric Mika,2020,2020,0,C,
3022,Ed Mikan,1949,1954,5,C,F
3023,George Mikan*,1949,1956,7,C,
3024,Larry Mikan,1971,1971,0,F,
3025,Vern Mikkelsen*,1950,1959,9,F,C
3026,Al Miksis,1950,1950,0,C,
3027,Aaron Miles,2006,2006,0,G,
3028,C.J. Miles,2006,2022,16,G,F
3029,Darius Miles,2001,2009,8,F,
3030,Eddie Miles,1964,1972,8,G,F
3031,Marko Milič,1998,1999,1,G,F
3032,Darko Miličić,2004,2013,9,F,C
3033,Nat Militzok,1947,1947,0,F,
3034,Andre Miller,2000,2016,16,G,
3035,Anthony Miller,1995,2005,10,F,
3036,Bill Miller,1949,1949,0,F,
3037,Bob Miller,1984,1984,0,F,
3038,Brad Miller,1999,2012,13,C,
3039,Darius Miller,2013,2021,8,F,
3040,Dick Miller,1981,1981,0,F,
3041,Eddie Miller,1953,1954,1,C,F
3042,Harry Miller,1947,1947,0,C,F
3043,Jay Miller,1968,1971,3,F,
3044,Larry Miller,1969,1975,6,G,F
3045,Malcolm Miller,2018,2020,2,F,
3046,Mike Miller,2001,2017,16,F,G
3047,Oliver Miller,1993,2004,11,C,
3048,Quincy Miller,2013,2015,2,F,
3049,Reggie Miller*,1988,2005,17,G,F
3050,Walt Miller,1947,1947,0,F,
3051,Chris Mills,1994,2003,9,F,
3052,John Mills,1947,1947,0,C,F
3053,Patty Mills,2010,2022,12,G,
3054,Terry Mills,1991,2001,10,F,
3055,Elijah Millsap,2015,2017,2,G,F
3056,Paul Millsap,2007,2022,15,F,
3057,Shake Milton,2019,2022,3,G,
3058,Harold Miner,1993,1996,3,G,
3059,Yao Ming*,2003,2011,8,C,
3060,Dirk Minniefield,1986,1988,2,G,
3061,Dave Minor,1952,1953,1,G,F
3062,Greg Minor,1995,1999,4,G,F
3063,Mark Minor,1973,1973,0,F,
3064,Nikola Mirotić,2015,2019,4,F,
3065,Wat Misaka,1948,1948,0,G,
3066,Jason Miskiri,2000,2000,0,G,
3067,Davion Mitchell,2022,2022,0,G,
3068,Donovan Mitchell,2018,2022,4,G,
3069,Leland Mitchell,1968,1968,0,G,
3070,Mike Mitchell,1979,1988,9,F,
3071,Murray Mitchell,1950,1950,0,C,
3072,Sam Mitchell,1990,2002,12,F,
3073,Todd Mitchell,1989,1989,0,F,
3074,Tony Mitchell,2014,2014,0,F,
3075,Tony Mitchell,2014,2014,0,F,
3076,Naz Mitrou-Long,2018,2020,2,G,
3077,Steve Mix,1970,1983,13,F,
3078,Bill Mlkvy,1953,1953,0,F,
3079,Cuttino Mobley,1999,2009,10,G,
3080,Eric Mobley,1995,1997,2,C,
3081,Evan Mobley,2022,2022,0,F,C
3082,Doug Moe,1968,1972,4,F,G
3083,Larry Moffett,1978,1978,0,F,
3084,Leo Mogus,1947,1951,4,F,C
3085,Nazr Mohammed,1999,2016,17,C,
3086,Jérôme Moïso,2001,2005,4,F,C
3087,Paul Mokeski,1980,1991,11,C,F
3088,Adam Mokoka,2020,2021,1,G,
3089,Jack Molinas,1954,1954,0,F,
3090,Wayne Molis,1967,1968,1,F,
3091,Sidney Moncrief*,1980,1991,11,G,
3092,Eric Money,1975,1980,5,G,
3093,Sergei Monia,2006,2006,0,F,
3094,Malik Monk,2018,2022,4,G,
3095,Earl Monroe*,1968,1980,12,G,
3096,Greg Monroe,2011,2022,11,C,F
3097,Rodney Monroe,1992,1992,0,G,
3098,Luis Montero,2016,2018,2,G,
3099,Howie Montgomery,1963,1963,0,F,
3100,Eric Montross,1995,2002,7,C,
3101,Moses Moody,2022,2022,0,G,
3102,Jamario Moon,2008,2012,4,F,
3103,Xavier Moon,2022,2022,0,G,
3104,Jim Mooney,1953,1953,0,F,
3105,Matt Mooney,2020,2022,2,G,
3106,Andre Moore,1988,1988,0,F,
3107,Ben Moore,2018,2018,0,F,
3108,E'Twaun Moore,2012,2021,9,G,F
3109,Gene Moore,1969,1975,6,C,F
3110,Jackie Moore,1955,1957,2,F,
3111,Johnny Moore,1981,1990,9,G,
3112,Larry Moore,1968,1968,0,F,
3113,Lowes Moore,1981,1983,2,G,
3114,Mikki Moore,1999,2012,13,C,F
3115,Otto Moore,1969,1977,8,C,F
3116,Richie Moore,1968,1968,0,G,
3117,Ron Moore,1988,1988,0,C,
3118,Tracy Moore,1992,1997,5,G,F
3119,Ja Morant,2020,2022,2,G,
3120,Eric Moreland,2015,2019,4,F,C
3121,Jackie Moreland,1961,1970,9,F,G
3122,Guy Morgan,1983,1983,0,G,
3123,Juwan Morgan,2020,2022,2,F,
3124,Rex Morgan,1971,1972,1,G,
3125,Elmore Morgenthaler,1947,1949,2,C,
3126,Darren Morningstar,1994,1994,0,C,
3127,Chris Morris,1989,1999,10,F,
3128,Darius Morris,2012,2015,3,G,
3129,Isaiah Morris,1993,1993,0,F,
3130,Jaylen Morris,2018,2022,4,G,
3131,Marcus Morris,2012,2022,10,F,
3132,Markieff Morris,2012,2022,10,F,
3133,Max Morris,1950,1950,0,F,C
3134,Monte Morris,2018,2022,4,G,
3135,Randolph Morris,2007,2010,3,C,
3136,Terence Morris,2002,2006,4,F,
3137,Adam Morrison,2007,2010,3,F,
3138,John Morrison,1968,1968,0,G,
3139,Mike Morrison,1990,1990,0,G,
3140,Red Morrison,1955,1958,3,F,C
3141,Anthony Morrow,2009,2017,8,G,
3142,Dwayne Morton,1995,1995,0,F,
3143,John Morton,1990,1992,2,G,
3144,Richard Morton,1989,1989,0,G,
3145,Glenn Mosley,1978,1979,1,F,
3146,Perry Moss,1986,1987,1,G,
3147,Lawrence Moten,1996,1998,2,G,
3148,Donatas Motiejūnas,2013,2019,6,F,C
3149,Johnathan Motley,2018,2020,2,F,
3150,Hanno Möttölä,2001,2002,1,C,
3151,Arnett Moultrie,2013,2014,1,F,
3152,Rick Mount,1971,1975,4,G,
3153,Alonzo Mourning*,1993,2008,15,C,
3154,Timofey Mozgov,2011,2018,7,C,
3155,Chuck Mrazovich,1951,1951,0,F,
3156,Emmanuel Mudiay,2016,2022,6,G,
3157,Erwin Mueller,1967,1974,7,C,F
3158,Shabazz Muhammad,2014,2018,4,F,G
3159,Mychal Mulder,2020,2022,2,G,F
3160,Joe Mullaney,1950,1950,0,G,
3161,Bob Mullens,1947,1947,0,G,
3162,Byron Mullens,2010,2014,4,C,
3163,Chris Mullin*,1986,2001,15,F,G
3164,Jeff Mullins,1965,1976,11,G,F
3165,Todd Mundt,1996,1996,0,C,
3166,Xavier Munford,2016,2018,2,G,
3167,Chris Munk,1991,1991,0,F,
3168,George Munroe,1947,1948,1,G,
3169,Eric Murdock,1992,2000,8,G,
3170,Gheorghe Mureșan,1994,2000,6,C,
3171,Ade Murkey,2022,2022,0,G,
3172,Allen Murphy,1976,1977,1,G,
3173,Calvin Murphy*,1971,1983,12,G,
3174,Dick Murphy,1947,1947,0,G,
3175,Erik Murphy,2014,2014,0,F,
3176,Jay Murphy,1985,1988,3,F,
3177,John Murphy,1947,1947,0,F,
3178,Kevin Murphy,2013,2013,0,G,
3179,Ronnie Murphy,1988,1988,0,F,
3180,Tod Murphy,1988,1994,6,C,F
3181,Trey Murphy III,2022,2022,0,F,
3182,Troy Murphy,2002,2013,11,F,C
3183,Dejounte Murray,2017,2022,5,G,
3184,Jamal Murray,2017,2021,4,G,
3185,Ken Murray,1951,1955,4,G,F
3186,Lamond Murray,1995,2006,11,F,
3187,Ronald Murray,2003,2010,7,G,
3188,Tracy Murray,1993,2004,11,F,
3189,Willie Murrell,1968,1970,2,F,
3190,Dorie Murrey,1967,1972,5,F,C
3191,Toure' Murry,2014,2015,1,G,F
3192,Džanan Musa,2019,2020,1,G,F
3193,Mike Muscala,2014,2022,8,F,C
3194,Angelo Musi,1947,1949,2,G,
3195,Jerrod Mustaf,1991,1994,3,F,C
3196,Dikembe Mutombo*,1992,2009,17,C,
3197,Martin Müürsepp,1997,1998,1,F,
3198,Pete Myers,1987,1998,11,G,F
3199,Svi Mykhailiuk,2019,2022,3,G,F
3200,Hamady N'Diaye,2011,2014,3,C,
3201,Makhtar N'Diaye,1999,1999,0,F,
3202,Mamadou N'Diaye,2001,2005,4,C,
3203,Boniface N'Dong,2006,2006,0,C,
3204,Bob Naber,1953,1953,0,F,
3205,Boris Nachamkin,1955,1955,0,F,
3206,Boštjan Nachbar,2003,2008,5,F,
3207,Abdel Nader,2018,2022,4,F,
3208,Jerry Nagel,1950,1950,0,G,
3209,Fritz Nagy,1949,1949,0,G,F
3210,Lee Nailon,2001,2006,5,F,
3211,Eduardo Nájera,2001,2012,11,F,
3212,Larry Nance,1982,1994,12,F,C
3213,Larry Nance Jr.,2016,2022,6,F,C
3214,Shabazz Napier,2015,2020,5,G,
3215,Paul Napolitano,1949,1949,0,F,G
3216,Bob Nash,1973,1979,6,F,
3217,Cotton Nash,1965,1968,3,F,
3218,Steve Nash*,1997,2014,17,G,
3219,Swen Nater,1974,1984,10,C,
3220,Howard Nathan,1996,1996,0,G,
3221,Calvin Natt,1980,1990,10,F,
3222,Kenny Natt,1981,1985,4,G,
3223,Willie Naulls,1957,1966,9,F,C
3224,Juan Carlos Navarro,2008,2008,0,G,
3225,Maurice Ndour,2017,2017,0,F,
3226,Craig Neal,1989,1991,2,G,
3227,Gary Neal,2011,2017,6,G,
3228,Jim Neal,1954,1955,1,C,
3229,Lloyd Neal,1973,1979,6,C,F
3230,Ed Nealy,1983,1993,10,F,
3231,Nemanja Nedović,2014,2014,0,G,
3232,Al Negratti,1947,1947,0,F,C
3233,Barry Nelson,1972,1972,0,C,
3234,DeMarcus Nelson,2009,2009,0,G,
3235,Don Nelson*,1963,1976,13,F,
3236,Jameer Nelson,2005,2018,13,G,
3237,Louie Nelson,1974,1978,4,G,
3238,Ron Nelson,1971,1971,0,G,
3239,RJ Nembhard Jr.,2022,2022,0,G,
3240,Ruben Nembhard,1997,1997,0,G,
3241,Dick Nemelka,1971,1971,0,G,
3242,Tyrone Nesby,1999,2002,3,F,
3243,Aaron Nesmith,2021,2022,1,G,F
3244,Martin Nessley,1988,1988,0,C,
3245,Rasho Nesterović,1999,2010,11,C,
3246,Raul Neto,2016,2022,6,G,
3247,Bob Netolicky,1968,1976,8,F,C
3248,Johnny Neumann,1972,1978,6,G,F
3249,Paul Neumann,1962,1967,5,G,
3250,Chuck Nevitt,1983,1994,11,C,
3251,Melvin Newbern,1993,1993,0,G,
3252,Ivano Newbill,1995,1998,3,F,
3253,Ira Newble,2001,2008,7,F,
3254,Mike Newlin,1972,1982,10,G,F
3255,Johnny Newman,1987,2002,15,F,G
3256,Malik Newman,2020,2022,2,G,
3257,Dave Newmark,1969,1971,2,C,
3258,Bill Newton,1973,1974,1,C,
3259,Georges Niang,2017,2022,5,F,
3260,Demetris Nichols,2008,2009,1,F,
3261,Jack Nichols,1949,1958,9,C,F
3262,Andrew Nicholson,2013,2017,4,F,
3263,Gaylon Nickerson,1997,1997,0,G,
3264,Carl Nicks,1981,1983,2,G,
3265,Rich Niemann,1969,1972,3,C,
3266,Richie Niemiera,1949,1950,1,G,F
3267,Mike Niles,1981,1981,0,F,
3268,Kurt Nimphius,1982,1990,8,C,F
3269,Daishen Nix,2022,2022,0,G,
3270,Dyron Nix,1990,1990,0,F,
3271,Norm Nixon,1978,1989,11,G,
3272,Zeke Nnaji,2021,2022,1,F,
3273,Joakim Noah,2008,2020,12,C,
3274,Chuck Noble,1956,1962,6,G,
3275,Andrés Nocioni,2005,2012,7,F,
3276,David Noel,2007,2007,0,F,
3277,Nerlens Noel,2015,2022,7,C,F
3278,Paul Noel,1948,1952,4,F,
3279,Lucas Nogueira,2015,2018,3,C,
3280,Jim Nolan,1950,1950,0,C,
3281,Paul Nolen,1954,1954,0,C,
3282,Jeff Nordgaard,1998,1998,0,F,
3283,Bevo Nordmann,1962,1965,3,C,
3284,Johnny Norlander,1947,1951,4,F,
3285,Connie Norman,1975,1979,4,G,
3286,Ken Norman,1988,1997,9,F,
3287,Audie Norris,1983,1985,2,C,
3288,Moochie Norris,1997,2006,9,G,
3289,Sylvester Norris,1980,1980,0,C,
3290,Zach Norvell,2020,2020,0,G,
3291,Willie Norwood,1972,1978,6,F,
3292,George Nostrand,1947,1950,3,C,F
3293,Stan Noszka,1947,1949,2,G,
3294,Mike Novak,1949,1954,5,C,F
3295,Steve Novak,2007,2017,10,F,
3296,Jaylen Nowell,2020,2022,2,G,
3297,Mel Nowell,1963,1968,5,G,
3298,Dirk Nowitzki,1999,2019,20,F,
3299,Frank Ntilikina,2018,2022,4,G,
3300,Kendrick Nunn,2020,2021,1,G,
3301,James Nunnally,2014,2021,7,F,
3302,Jusuf Nurkić,2015,2022,7,C,
3303,Dennis Nutt,1987,1987,0,G,
3304,David Nwaba,2017,2022,5,G,
3305,Jordan Nwora,2021,2022,1,F,
3306,Julius Nwosu,1995,1995,0,C,
3307,Charles O'Bannon,1998,1999,1,G,F
3308,Ed O'Bannon,1996,1997,1,F,
3309,John O'Boyle,1953,1953,0,G,
3310,Bob O'Brien,1948,1949,1,F,
3311,J.J. O'Brien,2016,2016,0,F,
3312,Jim O'Brien,1974,1975,1,F,
3313,Jimmy O'Brien,1972,1975,3,G,
3314,Ralph O'Brien,1952,1953,1,G,
3315,Johnny O'Bryant,2015,2018,3,F,C
3316,Patrick O'Bryant,2007,2010,3,C,
3317,Dermie O'Connell,1949,1950,1,G,
3318,Andy O'Donnell,1950,1950,0,G,
3319,Buddy O'Grady,1947,1949,2,G,
3320,Fran O'Hanlon,1971,1971,0,G,
3321,Dick O'Keefe,1948,1951,3,G,F
3322,Tommy O'Keefe,1951,1951,0,G,
3323,Mike O'Koren,1981,1988,7,F,G
3324,Grady O'Malley,1970,1970,0,F,
3325,Jermaine O'Neal,1997,2014,17,C,F
3326,Shaquille O'Neal*,1993,2011,18,C,
3327,Royce O'Neale,2018,2022,4,F,
3328,Mike O'Neill,1953,1953,0,F,
3329,Kyle O'Quinn,2013,2020,7,F,C
3330,Kevin O'Shea,1951,1953,2,G,
3331,Garland O'Shields,1947,1947,0,G,F
3332,Dan O'Sullivan,1991,1996,5,C,
3333,Charles Oakley,1986,2004,18,F,C
3334,Fabricio Oberto,2006,2011,5,C,F
3335,Daniel Ochefu,2017,2017,0,C,
3336,Greg Oden,2009,2014,5,C,
3337,Lamar Odom,2000,2013,13,F,
3338,Bud Ogden,1970,1971,1,F,
3339,Ralph Ogden,1971,1971,0,F,
3340,Alan Ogg,1991,1993,2,C,
3341,Don Ohl,1961,1970,9,G,
3342,Tim Ohlbrecht,2013,2013,0,C,
3343,Semi Ojeleye,2018,2022,4,F,
3344,Emeka Okafor,2005,2018,13,C,F
3345,Jahlil Okafor,2016,2021,5,C,F
3346,Chuma Okeke,2021,2022,1,F,
3347,Elie Okobo,2019,2020,1,G,
3348,Josh Okogie,2019,2022,3,G,
3349,Onyeka Okongwu,2021,2022,1,F,
3350,Isaac Okoro,2021,2022,1,G,F
3351,KZ Okpala,2020,2022,2,F,
3352,Mehmet Okur,2003,2012,9,C,F
3353,Victor Oladipo,2014,2021,7,G,
3354,Hakeem Olajuwon*,1985,2002,17,C,
3355,Mark Olberding,1976,1987,11,F,
3356,Jawann Oldham,1981,1991,10,C,
3357,John Oldham,1950,1951,1,G,
3358,Frank Oleynick,1976,1977,1,G,
3359,John Olive,1979,1980,1,F,
3360,Brian Oliver,1991,1998,7,G,
3361,Cameron Oliver,2021,2022,1,F,
3362,Dean Oliver,2002,2003,1,G,
3363,Jimmy Oliver,1992,1999,7,G,F
3364,Kevin Ollie,1998,2010,12,G,
3365,Gene Ollrich,1950,1950,0,G,
3366,Michael Olowokandi,1999,2007,8,C,
3367,Bud Olsen,1963,1970,7,F,C
3368,Kelly Olynyk,2014,2022,8,C,F
3369,Eugene Omoruyi,2022,2022,0,F,
3370,Miye Oni,2020,2022,2,G,
3371,Arinze Onuaku,2014,2017,3,C,
3372,Chinanu Onuaku,2017,2018,1,F,C
3373,Barry Orms,1969,1970,1,G,
3374,Johnny Orr,1950,1950,0,F,
3375,Louis Orr,1981,1988,7,F,
3376,José Ortiz,1989,1990,1,F,
3377,Daniel Orton,2012,2014,2,C,F
3378,Chuck Osborne,1962,1962,0,F,
3379,Cedi Osman,2018,2022,4,F,
3380,Wally Osterkorn,1952,1955,3,F,C
3381,Greg Ostertag,1996,2006,10,C,
3382,Matt Othick,1993,1993,0,G,
3383,Don Otten,1950,1953,3,C,
3384,Mac Otten,1950,1950,0,F,C
3385,Daniel Oturu,2021,2022,1,F,C
3386,Kelly Oubre Jr.,2016,2022,6,F,
3387,Bo Outlaw,1994,2008,14,F,
3388,Travis Outlaw,2004,2014,10,F,
3389,Claude Overton,1953,1953,0,G,
3390,Doug Overton,1993,2004,11,G,
3391,Andre Owens,2006,2008,2,G,
3392,Billy Owens,1992,2001,9,F,G
3393,Chris Owens,2003,2003,0,F,
3394,Eddie Owens,1978,1978,0,F,
3395,Jim Owens,1974,1975,1,F,
3396,Keith Owens,1992,1992,0,F,
3397,Larry Owens,2011,2012,1,F,
3398,Red Owens,1950,1952,2,G,F
3399,Tariq Owens,2020,2020,0,F,
3400,Tom Owens,1972,1983,11,C,F
3401,Ray Owes,1997,1997,0,F,
3402,Olumide Oyedeji,2001,2003,2,C,
3403,Joe Pace,1977,1978,1,C,
3404,Zaza Pachulia,2004,2019,15,C,
3405,Robert Pack,1992,2004,12,G,
3406,Wayne Pack,1975,1975,0,G,
3407,Gerald Paddio,1991,1994,3,F,G
3408,Scott Padgett,2000,2007,7,F,
3409,Dana Pagett,1972,1972,0,G,
3410,Jaysean Paige,2022,2022,0,G,
3411,Marcus Paige,2018,2018,0,G,
3412,Fred Paine,1949,1949,0,F,
3413,Milt Palacio,2000,2006,6,G,
3414,Togo Palazzi,1955,1960,5,F,G
3415,Bud Palmer,1947,1949,2,F,C
3416,Errol Palmer,1968,1968,0,F,
3417,Jim Palmer,1959,1961,2,F,C
3418,Trayvon Palmer,2022,2022,0,G,
3419,Walter Palmer,1991,1993,2,C,F
3420,Kevin Pangos,2022,2022,0,G,
3421,Andy Panko,2001,2001,0,F,
3422,Georgios Papagiannis,2017,2018,1,C,
3423,Kostas Papanikolaou,2015,2016,1,F,
3424,Jannero Pargo,2003,2015,12,G,
3425,Jeremy Pargo,2012,2020,8,G,
3426,Easy Parham,1949,1951,2,F,G
3427,Robert Parish*,1977,1997,20,C,
3428,Med Park,1956,1960,4,G,F
3429,Anthony Parker,1998,2012,14,G,
3430,Jabari Parker,2015,2022,7,F,
3431,Smush Parker,2003,2008,5,G,
3432,Sonny Parker,1977,1982,5,F,G
3433,Tony Parker,2002,2019,17,G,
3434,Barry Parkhill,1974,1976,2,G,
3435,Jack Parkinson,1950,1950,0,G,
3436,Charles Parks,1969,1969,0,F,
3437,Cherokee Parks,1996,2004,8,C,F
3438,Richard Parks,1968,1968,0,F,
3439,Jack Parr,1959,1959,0,C,
3440,Doyle Parrack,1947,1947,0,F,G
3441,Charlie Parsley,1950,1950,0,G,
3442,Chandler Parsons,2012,2020,8,F,
3443,Eric Paschall,2020,2022,2,F,
3444,Anžejs Pasečņiks,2020,2021,1,C,
3445,Žarko Paspalj,1990,1990,0,F,
3446,Marty Passaglia,1947,1949,2,G,
3447,George Pastushok,1947,1947,0,G,
3448,Myles Patrick,1981,1981,0,F,
3449,Stan Patrick,1950,1950,0,F,G
3450,Andrae Patterson,1999,2000,1,F,
3451,George Patterson,1968,1968,0,C,F
3452,Lamar Patterson,2016,2017,1,G,F
3453,Patrick Patterson,2011,2021,10,F,
3454,Ruben Patterson,1999,2008,9,F,
3455,Steve Patterson,1972,1976,4,C,
3456,Tom Patterson,1973,1974,1,F,
3457,Worthy Patterson,1958,1958,0,G,
3458,Justin Patton,2018,2021,3,C,
3459,Brandon Paul,2018,2018,0,G,
3460,Chris Paul,2006,2022,16,G,
3461,Charlie Paulk,1969,1972,3,F,C
3462,Jerry Paulson,1958,1958,0,G,
3463,Billy Paultz,1971,1985,14,C,F
3464,Sasha Pavlović,2004,2013,9,G,F
3465,Jim Paxson,1957,1958,1,F,G
3466,Jim Paxson,1980,1990,10,G,F
3467,John Paxson,1984,1994,10,G,
3468,Johnny Payak,1950,1953,3,G,F
3469,Adreian Payne,2015,2018,3,F,C
3470,Cameron Payne,2016,2022,6,G,
3471,Kenny Payne,1990,1993,3,F,G
3472,Tom Payne,1972,1972,0,C,
3473,Elfrid Payton,2015,2022,7,G,
3474,Gary Payton*,1991,2007,16,G,
3475,Gary Payton II,2017,2022,5,G,
3476,Mel Payton,1952,1953,1,F,G
3477,George Pearcy,1947,1947,0,G,
3478,Henry Pearcy,1947,1947,0,G,
3479,Oleksiy Pecherov,2008,2010,2,C,
3480,Wiley Peck,1980,1980,0,G,
3481,Rich Peek,1968,1968,0,C,
3482,Anthony Peeler,1993,2005,12,G,
3483,George Peeples,1968,1973,5,C,F
3484,Nikola Peković,2011,2016,5,C,
3485,Jake Pelkington,1949,1949,0,C,F
3486,Norvel Pelle,2020,2022,2,F,C
3487,Sam Pellom,1980,1983,3,F,C
3488,Mike Penberthy,2001,2002,1,G,
3489,Jerry Pender,1974,1974,0,G,
3490,Desmond Penigar,2004,2004,0,F,
3491,Kirk Penney,2004,2005,1,G,
3492,Mike Peplowski,1994,1996,2,C,
3493,Will Perdue,1989,2001,12,C,
3494,Kendrick Perkins,2004,2018,14,C,
3495,Sam Perkins,1985,2001,16,F,C
3496,Warren Perkins,1950,1951,1,G,F
3497,Kosta Perović,2008,2008,0,C,
3498,London Perrantes,2018,2018,0,G,
3499,Aulcie Perry,1975,1975,0,C,
3500,Curtis Perry,1971,1978,7,F,
3501,Elliot Perry,1992,2002,10,G,
3502,Reggie Perry,2021,2022,1,F,C
3503,Ron Perry,1968,1970,2,G,
3504,Tim Perry,1989,1996,7,F,C
3505,Chuck Person,1987,2000,13,F,
3506,Wesley Person,1995,2005,10,G,
3507,Alec Peters,2018,2018,0,F,
3508,Jim Petersen,1985,1992,7,F,C
3509,Loy Petersen,1969,1970,1,G,
3510,Bob Peterson,1954,1956,2,F,
3511,Ed Peterson,1950,1951,1,C,
3512,Mel Peterson,1964,1970,6,G,F
3513,Morris Peterson,2001,2011,10,F,
3514,Geoff Petrie,1971,1976,5,G,
3515,Johan Petro,2006,2013,7,C,
3516,Dražen Petrović*,1990,1993,3,G,
3517,Richard Petruška,1994,1994,0,C,F
3518,Bob Pettit*,1955,1965,10,F,C
3519,Jerry Pettway,1968,1969,1,G,F
3520,Roger Phegley,1979,1984,5,G,F
3521,Jack Phelan,1950,1950,0,F,
3522,Jim Phelan,1954,1954,0,G,
3523,Derrick Phelps,1995,1995,0,G,
3524,Michael Phelps,1986,1988,2,G,
3525,Andy Phillip*,1948,1958,10,G,F
3526,Eddie Phillips,1983,1983,0,F,
3527,Gary Phillips,1962,1966,4,G,
3528,Gene Phillips,1972,1973,1,G,
3529,Bobby Phills,1992,2000,8,G,
3530,Eric Piatkowski,1995,2008,13,G,F
3531,Walter Piatkowski,1969,1972,3,F,
3532,Jamorko Pickett,2022,2022,0,G,F
3533,Paul Pierce*,1999,2017,18,F,G
3534,Ricky Pierce,1983,1998,15,G,
3535,Stan Pietkiewicz,1979,1981,2,G,F
3536,Mickaël Piétrus,2004,2013,9,G,F
3537,John Pilch,1952,1952,0,F,
3538,Ed Pinckney,1986,1997,11,F,
3539,Kevinn Pinkney,2007,2007,0,F,
3540,John Pinone,1984,1984,0,F,
3541,Theo Pinson,2019,2022,3,G,
3542,Dave Piontek,1957,1963,6,F,C
3543,Tom Piotrowski,1984,1984,0,C,
3544,Scottie Pippen*,1988,2004,16,F,G
3545,Charles Pittman,1983,1986,3,F,
3546,Dexter Pittman,2011,2014,3,C,
3547,Zoran Planinić,2004,2006,2,G,
3548,Tibor Pleiß,2016,2016,0,C,
3549,Marshall Plumlee,2017,2018,1,C,
3550,Mason Plumlee,2014,2022,8,C,F
3551,Miles Plumlee,2013,2019,6,C,F
3552,Gary Plummer,1985,1993,8,F,C
3553,Pavel Podkolzin,2005,2006,1,C,
3554,Jakob Poeltl,2017,2022,5,C,
3555,Vincent Poirier,2020,2021,1,C,
3556,Aleksej Pokusevski,2021,2022,1,F,
3557,Dwayne Polee,1987,1987,0,G,
3558,Jim Pollard*,1949,1955,6,F,C
3559,Scot Pollard,1998,2008,10,C,
3560,Ralph Polson,1953,1953,0,F,C
3561,Olden Polynice,1988,2004,16,C,F
3562,Cliff Pondexter,1976,1978,2,F,C
3563,Quincy Pondexter,2011,2019,8,G,F
3564,Shamorie Ponds,2020,2020,0,G,
3565,Yves Pons,2022,2022,0,F,
3566,Jordan Poole,2020,2022,2,G,
3567,David Pope,1985,1986,1,F,
3568,Mark Pope,1998,2005,7,F,
3569,Dave Popson,1989,1992,3,F,C
3570,Ben Poquette,1978,1987,9,F,C
3571,Chris Porter,2001,2001,0,F,
3572,Howard Porter,1972,1978,6,F,C
3573,Jontay Porter,2021,2021,0,F,C
3574,Kevin Porter,1973,1983,10,G,
3575,Kevin Porter Jr.,2020,2022,2,G,
3576,Michael Porter Jr.,2020,2022,2,F,
3577,Otto Porter Jr.,2014,2022,8,F,
3578,Terry Porter,1986,2002,16,G,
3579,Willie Porter,1968,1969,1,F,
3580,Bobby Portis,2016,2022,6,F,
3581,Bob Portman,1970,1973,3,F,
3582,Kristaps Porziņģis,2016,2022,6,F,C
3583,James Posey,2000,2011,11,F,G
3584,Lavor Postell,2001,2003,2,G,
3585,John Postley,1968,1968,0,F,
3586,Vitaly Potapenko,1997,2007,10,C,
3587,Micah Potter,2022,2022,0,C,
3588,Leon Powe,2007,2011,4,F,
3589,Cincinnatus Powell,1968,1975,7,F,C
3590,Dwight Powell,2015,2022,7,F,C
3591,Josh Powell,2006,2014,8,F,
3592,Kasib Powell,2008,2008,0,F,
3593,Myles Powell,2022,2022,0,G,
3594,Norman Powell,2016,2022,6,G,
3595,Roger Powell,2007,2007,0,F,
3596,Alex Poythress,2017,2019,2,F,
3597,Marlbert Pradd,1968,1969,1,G,
3598,Mike Pratt,1971,1972,1,G,F
3599,Paul Pressey,1983,1993,10,G,F
3600,Phil Pressey,2014,2016,2,G,
3601,Dominic Pressley,1989,1989,0,G,
3602,Harold Pressley,1987,1990,3,F,G
3603,Stephen Previs,1973,1973,0,G,
3604,A.J. Price,2010,2015,5,G,
3605,Brent Price,1993,2002,9,G,
3606,Jim Price,1973,1979,6,G,
3607,Mark Price,1987,1998,11,G,
3608,Mike Price,1971,1973,2,G,
3609,Ronnie Price,2006,2017,11,G,
3610,Tony Price,1981,1981,0,G,
3611,Bob Priddy,1953,1953,0,F,
3612,Pablo Prigioni,2013,2016,3,G,
3613,Joshua Primo,2022,2022,0,G,
3614,Taurean Prince,2017,2022,5,F,
3615,Tayshaun Prince,2003,2016,13,F,
3616,John Pritchard,1950,1950,0,C,
3617,Kevin Pritchard,1991,1996,5,G,
3618,Payton Pritchard,2021,2022,1,G,
3619,Laron Profit,2000,2006,6,G,F
3620,Gabe Pruitt,2008,2009,1,G,
3621,Joel Przybilla,2001,2013,12,C,
3622,Les Pugh,1949,1950,1,C,F
3623,Roy Pugh,1949,1949,0,C,F
3624,Anthony Pullard,1993,1993,0,F,
3625,Jacob Pullen,2018,2018,0,G,
3626,Rodney Purvis,2018,2018,0,G,
3627,Don Putman,1947,1950,3,G,
3628,Zhou Qi,2018,2019,1,F,C
3629,Tim Quarterman,2017,2018,1,G,
3630,Trevelin Queen,2022,2022,0,G,
3631,Neemias Queta,2022,2022,0,C,
3632,Bob Quick,1969,1972,3,F,G
3633,Immanuel Quickley,2021,2022,1,G,
3634,Chris Quinn,2007,2013,6,G,
3635,Brian Quinnett,1990,1992,2,F,
3636,Ivan Rabb,2018,2019,1,F,
3637,Luther Rackley,1970,1974,4,C,
3638,Howie Rader,1949,1949,0,G,F
3639,Mark Radford,1982,1983,1,G,
3640,Wayne Radford,1979,1979,0,G,
3641,Dino Radja*,1994,1997,3,F,C
3642,Vladimir Radmanović,2002,2013,11,F,
3643,Aleksandar Radojević,2000,2005,5,C,
3644,Frank Radovich,1962,1962,0,F,
3645,Moe Radovich,1953,1953,0,G,
3646,Miroslav Raduljica,2014,2015,1,C,
3647,Ray Radziszewski,1958,1958,0,F,
3648,Ray Ragelis,1952,1952,0,F,
3649,Sherwin Raiken,1953,1953,0,G,
3650,Ed Rains,1982,1983,1,F,
3651,Igor Rakočević,2003,2003,0,G,
3652,Kurt Rambis,1982,1995,13,F,
3653,Peter John Ramos,2005,2005,0,C,
3654,Cal Ramsey,1960,1961,1,F,
3655,Frank Ramsey*,1955,1964,9,F,G
3656,Jahmi'us Ramsey,2021,2022,1,G,
3657,Ray Ramsey,1949,1949,0,G,F
3658,Mark Randall,1992,1995,3,F,
3659,Chasson Randle,2017,2021,4,G,
3660,Julius Randle,2015,2022,7,F,C
3661,Anthony Randolph,2009,2014,5,F,
3662,Shavlik Randolph,2006,2015,9,F,
3663,Zach Randolph,2002,2018,16,F,C
3664,Wally Rank,1981,1981,0,F,G
3665,Kelvin Ransey,1981,1986,5,G,
3666,Sam Ranzino,1952,1952,0,G,
3667,Bobby Rascoe,1968,1970,2,G,F
3668,Blair Rasmussen,1986,1993,7,C,
3669,Xavier Rathan-Mayes,2018,2018,0,G,
3670,George Ratkovicz,1950,1955,5,C,F
3671,Ed Ratleff,1974,1978,4,F,G
3672,Mike Ratliff,1973,1974,1,C,
3673,Theo Ratliff,1996,2011,15,C,F
3674,Andy Rautins,2011,2011,0,G,
3675,Leo Rautins,1984,1985,1,F,
3676,Allan Ray,2007,2007,0,G,
3677,Clifford Ray,1972,1981,9,C,
3678,Don Ray,1950,1950,0,F,C
3679,James Ray,1981,1983,2,F,
3680,Jim Ray,1957,1960,3,G,
3681,Jimmy Rayl,1968,1969,1,G,
3682,Craig Raymond,1969,1973,4,C,
3683,Connie Rea,1954,1954,0,G,F
3684,Austin Reaves,2022,2022,0,G,
3685,Joe Reaves,1974,1974,0,F,
3686,Josh Reaves,2020,2020,0,G,
3687,Željko Rebrača,2002,2006,4,C,
3688,Eldridge Recasner,1995,2002,7,G,
3689,Michael Redd,2001,2012,11,G,
3690,Cam Reddish,2020,2022,2,F,
3691,Frank Reddout,1954,1954,0,F,
3692,J.J. Redick,2007,2021,14,G,
3693,Marlon Redmond,1979,1980,1,G,
3694,Davon Reed,2018,2022,4,G,
3695,Hub Reed,1959,1965,6,C,F
3696,Justin Reed,2005,2007,2,F,
3697,Paul Reed,2021,2022,1,F,
3698,Ron Reed,1966,1967,1,F,
3699,Willie Reed,2016,2018,2,F,C
3700,Willis Reed*,1965,1974,9,C,F
3701,Bryant Reeves,1996,2001,5,C,
3702,Khalid Reeves,1995,2000,5,G,
3703,Richie Regan,1956,1958,2,G,
3704,Don Rehfeldt,1951,1952,1,F,
3705,Billy Reid,1981,1981,0,G,
3706,Don Reid,1996,2003,7,F,
3707,J.R. Reid,1990,2001,11,F,
3708,Jim Reid,1968,1968,0,F,
3709,Naz Reid,2020,2022,2,F,
3710,Robert Reid,1978,1991,13,F,G
3711,Ryan Reid,2012,2012,0,F,
3712,Jared Reiner,2005,2007,2,C,
3713,Chick Reiser,1948,1950,2,G,F
3714,Richard Rellford,1988,1988,0,F,
3715,Terrence Rencher,1996,1996,0,G,
3716,John Rennicke,1952,1952,0,G,
3717,Bob Rensberger,1947,1947,0,F,
3718,Efthimios Rentzias,2003,2003,0,C,
3719,Shawn Respert,1996,1999,3,G,
3720,Kevin Restani,1975,1982,7,F,C
3721,Cameron Reynolds,2019,2021,2,G,
3722,George Reynolds,1970,1970,0,G,
3723,Jerry Reynolds,1986,1996,10,G,F
3724,Kendall Rhine,1968,1969,1,C,
3725,Gene Rhodes,1953,1953,0,G,
3726,Rodrick Rhodes,1998,2000,2,G,F
3727,Glen Rice,1990,2004,14,F,
3728,Glen Rice Jr.,2014,2015,1,G,
3729,Chris Richard,2008,2010,2,F,
3730,Nick Richards,2021,2022,1,F,C
3731,Clint Richardson,1980,1987,7,G,
3732,Jason Richardson,2002,2015,13,G,
3733,Jeremy Richardson,2007,2009,2,G,F
3734,Josh Richardson,2016,2022,6,G,
3735,Malachi Richardson,2017,2019,2,G,
3736,Micheal Ray Richardson,1979,1986,7,G,F
3737,Norm Richardson,2002,2002,0,G,
3738,Pooh Richardson,1990,1999,9,G,
3739,Quentin Richardson,2001,2013,12,G,
3740,Mitch Richmond*,1989,2002,13,G,
3741,John Richter,1960,1960,0,F,
3742,Dick Ricketts,1956,1958,2,F,C
3743,Isaiah Rider,1994,2002,8,G,
3744,Jackie Ridgle,1972,1972,0,G,
3745,Luke Ridnour,2004,2015,11,G,
3746,Mel Riebe,1947,1949,2,G,F
3747,Bob Riedy,1968,1968,0,F,
3748,Jim Riffey,1951,1951,0,F,
3749,Antoine Rigaudeau,2003,2003,0,G,
3750,Tom Riker,1973,1975,2,C,F
3751,Bob Riley,1971,1971,0,F,
3752,Eric Riley,1994,1999,5,C,
3753,Pat Riley*,1968,1976,8,G,F
3754,Ron Riley,1973,1976,3,F,
3755,Grant Riller,2021,2021,0,G,
3756,Rich Rinaldi,1972,1974,2,G,
3757,Mike Riordan,1969,1977,8,G,F
3758,Arnie Risen*,1949,1958,9,C,F
3759,Tex Ritter,1949,1951,2,G,F
3760,Ramón Rivas,1989,1989,0,F,C
3761,Austin Rivers,2013,2022,9,G,
3762,David Rivers,1989,1992,3,G,
3763,Doc Rivers,1984,1996,12,G,
3764,Lee Robbins,1948,1949,1,F,
3765,Red Robbins,1968,1975,7,F,C
3766,Andre Roberson,2014,2021,7,G,F
3767,Anthony Roberson,2006,2009,3,G,
3768,Rick Roberson,1970,1976,6,C,F
3769,Terrance Roberson,2001,2001,0,F,
3770,Anthony Roberts,1978,1984,6,F,G
3771,Bill Roberts,1949,1950,1,C,
3772,Brian Roberts,2013,2017,4,G,
3773,Fred Roberts,1984,1997,13,F,C
3774,Joe Roberts,1961,1968,7,F,
3775,Lawrence Roberts,2006,2007,1,F,
3776,Marv Roberts,1972,1977,5,F,C
3777,Stanley Roberts,1992,2000,8,C,
3778,Alvin Robertson,1985,1996,11,G,
3779,Oscar Robertson*,1961,1974,13,G,F
3780,Ryan Robertson,2000,2000,0,G,
3781,Tony Robertson,1978,1979,1,G,
3782,Rick Robey,1979,1986,7,C,F
3783,Bernard Robinson,2005,2007,2,G,F
3784,Chris Robinson,1997,1998,1,G,
3785,Cliff Robinson,1980,1992,12,F,
3786,Clifford Robinson,1990,2007,17,F,C
3787,David Robinson*,1990,2003,13,C,
3788,Devin Robinson,2018,2019,1,F,
3789,Duncan Robinson,2019,2022,3,G,F
3790,Eddie Robinson,2000,2004,4,G,F
3791,Flynn Robinson,1967,1974,7,G,
3792,Glenn Robinson,1995,2005,10,F,
3793,Glenn Robinson III,2015,2021,6,G,F
3794,Jackie Robinson,1979,1982,3,F,
3795,Jamal Robinson,2001,2001,0,F,
3796,James Robinson,1994,2001,7,G,
3797,Jerome Robinson,2019,2021,2,G,
3798,Justin Robinson,2020,2022,2,G,
3799,Larry Robinson,1991,2002,11,F,G
3800,Mitchell Robinson,2019,2022,3,C,
3801,Nate Robinson,2006,2016,10,G,
3802,Oliver Robinson,1983,1983,0,G,
3803,Ronnie Robinson,1974,1975,1,F,
3804,Rumeal Robinson,1991,1997,6,G,
3805,Samuel Robinson,1971,1972,1,F,
3806,Thomas Robinson,2013,2017,4,F,
3807,Truck Robinson,1975,1985,10,F,C
3808,Wayne Robinson,1981,1981,0,F,
3809,Wilbert Robinson,1974,1974,0,G,
3810,Jeremiah Robinson-Earl,2022,2022,0,F,
3811,Bill Robinzine,1976,1982,6,F,
3812,Dave Robisch,1972,1984,12,C,F
3813,Isaiah Roby,2020,2022,2,F,
3814,Red Rocha,1948,1957,9,C,F
3815,John Roche,1972,1982,10,G,
3816,Gene Rock,1948,1948,0,G,
3817,Jack Rocker,1948,1948,0,C,F
3818,Guy Rodgers*,1959,1970,11,G,
3819,Dennis Rodman*,1987,2000,13,F,
3820,Sergio Rodríguez,2007,2017,10,G,
3821,Lou Roe,1996,1997,1,F,
3822,Carlos Rogers,1995,2002,7,C,F
3823,Harry Rogers,1976,1976,0,F,
3824,Johnny Rogers,1987,1988,1,F,C
3825,Marshall Rogers,1977,1977,0,G,
3826,Rodney Rogers,1994,2005,11,F,
3827,Roy Rogers,1997,2000,3,F,
3828,Willie Rogers,1969,1969,0,G,F
3829,Al Roges,1954,1955,1,G,F
3830,Ken Rohloff,1964,1964,0,G,
3831,Kenny Rollins,1949,1953,4,G,
3832,Phil Rollins,1959,1961,2,G,
3833,Tree Rollins,1978,1995,17,C,
3834,Lorenzo Romar,1981,1985,4,G,
3835,Rajon Rondo,2007,2022,15,G,
3836,Jerry Rook,1970,1970,0,F,
3837,Sean Rooks,1993,2004,11,C,
3838,Derrick Rose,2009,2022,13,G,
3839,Jalen Rose,1995,2007,12,G,F
3840,Malik Rose,1997,2009,12,F,C
3841,Rob Rose,1989,1989,0,G,
3842,Petey Rosenberg,1947,1947,0,G,
3843,Lennie Rosenbluth,1958,1959,1,F,
3844,Hank Rosenstein,1947,1947,0,F,
3845,Dick Rosenthal,1955,1957,2,F,G
3846,Quinton Ross,2005,2011,6,G,
3847,Terrence Ross,2013,2022,9,F,G
3848,Doug Roth,1990,1990,0,C,
3849,Scott Roth,1988,1990,2,F,
3850,Irv Rothenberg,1947,1949,2,C,
3851,Mickey Rottner,1947,1948,1,G,
3852,Dan Roundfield,1976,1987,11,F,C
3853,Giff Roux,1947,1949,2,F,C
3854,Ron Rowan,1987,1987,0,G,
3855,Curtis Rowe,1972,1979,7,F,
3856,Jim Rowinski,1989,1990,1,F,C
3857,Derrick Rowland,1986,1986,0,G,
3858,Brian Rowsom,1988,1990,2,F,
3859,Brandon Roy,2007,2013,6,G,
3860,Donald Royal,1990,1998,8,F,
3861,Reggie Royals,1975,1975,0,C,
3862,Bob Royer,1950,1950,0,G,
3863,Clifford Rozier,1995,1998,3,C,F
3864,Terry Rozier,2016,2022,6,G,
3865,Ricky Rubio,2012,2022,10,G,
3866,Guy Rucker,2003,2003,0,F,C
3867,Delaney Rudd,1990,1993,3,G,
3868,John Rudd,1979,1979,0,F,
3869,Damjan Rudež,2015,2017,2,F,
3870,John Rudometkin,1963,1965,2,F,
3871,Michael Ruffin,2000,2009,9,F,
3872,Trevor Ruffin,1995,1996,1,G,
3873,Paul Ruffner,1971,1976,5,C,F
3874,Joe Ruklick,1960,1962,2,F,C
3875,Jeff Ruland,1982,1993,11,C,F
3876,Bob Rule,1968,1975,7,C,F
3877,Jerry Rullo,1947,1950,3,G,
3878,Stefano Rusconi,1996,1996,0,C,F
3879,Brandon Rush,2009,2017,8,G,F
3880,Kareem Rush,2003,2010,7,G,
3881,Bill Russell*,1957,1969,12,C,
3882,Bryon Russell,1994,2006,12,F,
3883,Campy Russell,1975,1985,10,F,
3884,Cazzie Russell,1967,1978,11,F,G
3885,D'Angelo Russell,2016,2022,6,G,
3886,Frank Russell,1973,1973,0,G,
3887,Pierre Russell,1972,1973,1,F,G
3888,Rubin Russell,1968,1968,0,G,
3889,Walker Russell,1983,1988,5,G,
3890,Walker Russell,2012,2012,0,G,
3891,Arvydas Sabonis*,1996,2003,7,C,
3892,Domantas Sabonis,2017,2022,5,F,C
3893,Robert Sacre,2013,2016,3,C,
3894,Ed Sadowski,1947,1950,3,C,
3895,Kenny Sailors,1947,1951,4,G,
3896,John Salley,1987,2000,13,F,C
3897,John Salmons,2003,2015,12,G,
3898,Al Salvadori,1968,1968,0,F,
3899,Kevin Salvadori,1997,1998,1,C,
3900,Soumaila Samake,2001,2003,2,C,
3901,Luka Šamanić,2020,2021,1,F,
3902,Cheikh Samb,2008,2009,1,C,
3903,Brandon Sampson,2019,2019,0,G,
3904,JaKarr Sampson,2015,2021,6,G,F
3905,Jamal Sampson,2003,2007,4,F,C
3906,Ralph Sampson*,1984,1992,8,C,F
3907,Samardo Samuels,2011,2013,2,F,
3908,Pepe Sánchez,2001,2003,2,G,
3909,Al Sanders,1973,1973,0,F,
3910,Frankie Sanders,1979,1981,2,F,G
3911,Jeff Sanders,1990,1993,3,F,
3912,Larry Sanders,2011,2017,6,C,F
3913,Melvin Sanders,2006,2006,0,G,F
3914,Mike Sanders,1983,1993,10,F,G
3915,Tom Sanders*,1961,1973,12,F,
3916,Ron Sanford,1972,1972,0,F,
3917,Daniel Santiago,2001,2005,4,C,
3918,Bob Santini,1956,1956,0,F,
3919,Wayne Sappleton,1985,1985,0,F,
3920,Dario Šarić,2017,2021,4,F,C
3921,Olivier Sarr,2022,2022,0,C,
3922,Jason Sasser,1997,1999,2,F,
3923,Jeryl Sasser,2002,2003,1,G,
3924,Tomáš Satoranský,2017,2022,5,G,
3925,Kenny Satterfield,2002,2003,1,G,
3926,Pep Saul,1950,1955,5,G,F
3927,Woody Sauldsberry,1958,1966,8,F,C
3928,Glynn Saulters,1969,1969,0,G,
3929,Fred Saunders,1975,1978,3,F,
3930,Don Savage,1952,1957,5,F,G
3931,Predrag Savović,2003,2003,0,G,
3932,Alan Sawyer,1951,1951,0,F,
3933,Brian Scalabrine,2002,2012,10,F,
3934,Alex Scales,2006,2006,0,G,
3935,DeWayne Scales,1981,1984,3,F,
3936,Frank Schade,1973,1973,0,G,
3937,Ben Schadler,1948,1948,0,F,
3938,Herm Schaefer,1949,1950,1,G,F
3939,Billy Schaeffer,1974,1976,2,F,
3940,Bob Schafer,1956,1957,1,G,
3941,Jordan Schakel,2022,2022,0,F,
3942,Ben Scharnus,1947,1949,2,F,
3943,Marv Schatzman,1950,1950,0,F,
3944,Fred Schaus,1950,1954,4,F,
3945,Danny Schayes,1982,1999,17,C,F
3946,Dolph Schayes*,1950,1964,14,F,C
3947,Ossie Schectman,1947,1947,0,G,
3948,Steve Scheffler,1991,1997,6,C,F
3949,Tom Scheffler,1985,1985,0,C,
3950,Dave Schellhase,1967,1968,1,G,
3951,Luke Schenscher,2006,2007,1,C,
3952,Herb Scherer,1951,1952,1,C,
3953,Dwayne Schintzius,1991,1999,8,C,
3954,Dale Schlueter,1969,1978,9,C,
3955,Otto Schnellbacher,1949,1949,0,F,G
3956,Dick Schnittker,1951,1958,7,F,
3957,Russ Schoene,1983,1989,6,F,C
3958,Admiral Schofield,2020,2022,2,G,F
3959,Dave Scholz,1970,1970,0,F,
3960,Milt Schoon,1947,1950,3,C,
3961,Detlef Schrempf,1986,2001,15,F,C
3962,Dennis Schröder,2014,2022,8,G,
3963,Howie Schultz,1950,1953,3,C,F
3964,Dick Schulz,1947,1950,3,F,G
3965,Roger Schurig,1968,1968,0,G,
3966,John Schweitz,1985,1987,2,G,
3967,Luis Scola,2008,2017,9,F,
3968,Fred Scolari,1947,1955,8,G,
3969,Alvin Scott,1978,1985,7,F,G
3970,Brent Scott,1997,1997,0,F,C
3971,Byron Scott,1984,1997,13,G,
3972,Charlie Scott*,1971,1980,9,G,F
3973,Dennis Scott,1991,2000,9,F,
3974,James Scott,1997,1997,0,F,
3975,Mike Scott,2013,2021,8,F,
3976,Ray Scott,1962,1972,10,F,C
3977,Shawnelle Scott,1997,2002,5,C,
3978,Tre Scott,2022,2022,0,F,
3979,Willie Scott,1970,1970,0,F,
3980,Paul Scranton,1968,1968,0,F,
3981,Jay Scrubb,2021,2022,1,G,F
3982,Carey Scurry,1986,1988,2,F,
3983,Bruce Seals,1974,1978,4,F,
3984,Shea Seals,1998,1998,0,G,
3985,Malik Sealy,1993,2000,7,G,
3986,Ed Searcy,1976,1976,0,F,
3987,Kenny Sears,1956,1964,8,F,
3988,Wayne See,1950,1950,0,G,
3989,Thabo Sefolosha,2007,2020,13,G,F
3990,Rony Seikaly,1989,1999,10,C,
3991,Glen Selbo,1950,1950,0,G,F
3992,Josh Selby,2012,2013,1,G,
3993,Wayne Selden,2017,2022,5,G,F
3994,Brad Sellers,1987,1993,6,C,F
3995,Phil Sellers,1977,1977,0,F,G
3996,Rollie Seltz,1950,1950,0,G,F
3997,Lester Selvage,1968,1970,2,G,
3998,Frank Selvy,1955,1964,9,G,F
3999,Jim Seminoff,1947,1950,3,G,F
4000,Mouhamed Sene,2007,2009,2,C,F
4001,George Senesky,1947,1954,7,G,
4002,Alperen Şengün,2022,2022,0,F,
4003,Kevin Séraphin,2011,2017,6,F,
4004,Ansu Sesay,2002,2005,3,F,
4005,Ramon Sessions,2008,2018,10,G,
4006,Ha Seung-Jin,2005,2006,1,C,
4007,Tom Sewell,1985,1985,0,G,
4008,Collin Sexton,2019,2022,3,G,
4009,Paul Seymour,1948,1960,12,G,F
4010,Nick Shaback,1947,1947,0,G,
4011,Lynn Shackelford,1970,1970,0,F,
4012,Charles Shackleford,1989,1999,10,F,C
4013,Carl Shaeffer,1950,1951,1,F,G
4014,Lee Shaffer,1962,1964,2,F,
4015,Mustafa Shakur,2011,2014,3,G,
4016,Landry Shamet,2019,2022,3,G,
4017,God Shammgod,1998,1998,0,G,
4018,Earl Shannon,1947,1949,2,G,F
4019,Howie Shannon,1949,1950,1,G,F
4020,Chuck Share,1952,1960,8,C,
4021,Bill Sharman*,1951,1961,10,G,
4022,Day'Ron Sharpe,2022,2022,0,C,
4023,Walter Sharpe,2009,2009,0,F,
4024,John Shasky,1989,1991,2,C,
4025,Ron Shavlik,1957,1958,1,F,
4026,Brian Shaw,1989,2003,14,G,
4027,Casey Shaw,1999,1999,0,C,
4028,Marial Shayok,2020,2020,0,G,
4029,Bob Shea,1947,1947,0,F,
4030,Fred Sheffield,1947,1947,0,F,
4031,Craig Shelton,1981,1982,1,F,
4032,Lonnie Shelton,1977,1986,9,F,C
4033,Tornike Shengelia,2013,2014,1,F,
4034,Billy Shepherd,1973,1975,2,G,
4035,Jeff Sheppard,1999,1999,0,G,
4036,Steve Sheppard,1978,1979,1,F,
4037,Ed Sherod,1983,1983,0,G,
4038,Charley Shipp,1950,1950,0,G,F
4039,Paul Shirley,2003,2005,2,F,C
4040,Gene Short,1976,1976,0,F,
4041,Purvis Short,1979,1990,11,F,G
4042,Dexter Shouse,1990,1990,0,G,
4043,Dick Shrider,1949,1949,0,G,
4044,Gene Shue,1955,1964,9,G,
4045,John Shumate,1976,1981,5,F,C
4046,Iman Shumpert,2012,2021,9,G,
4047,Alexey Shved,2013,2015,2,G,
4048,Pascal Siakam,2017,2022,5,F,
4049,Jordan Sibert,2019,2019,0,G,
4050,Sam Sibert,1973,1973,0,F,
4051,Mark Sibley,1974,1974,0,G,
4052,Jerry Sichting,1981,1990,9,G,
4053,Donald Sidle,1969,1972,3,F,C
4054,Larry Siegfried,1964,1972,8,F,
4055,Ralph Siewert,1947,1947,0,C,
4056,Jack Sikma*,1978,1991,13,C,F
4057,James Silas,1973,1982,9,G,
4058,Paul Silas,1965,1980,15,F,C
4059,Xavier Silas,2012,2018,6,G,
4060,Garret Siler,2011,2011,0,C,
4061,Mike Silliman,1971,1971,0,F,
4062,Chris Silva,2020,2022,2,F,
4063,Wayne Simien,2006,2007,1,F,
4064,Ben Simmons,2018,2021,3,G,F
4065,Bobby Simmons,2002,2012,10,G,F
4066,Cedric Simmons,2007,2009,2,F,
4067,Connie Simmons,1947,1956,9,C,F
4068,Grant Simmons,1968,1969,1,G,
4069,Johnny Simmons,1947,1947,0,G,
4070,Jonathon Simmons,2016,2019,3,G,F
4071,Kobi Simmons,2018,2019,1,G,
4072,Lionel Simmons,1991,1997,6,F,G
4073,Miles Simon,1999,1999,0,G,
4074,Walter Simon,1968,1974,6,F,G
4075,Marko Simonovic,2022,2022,0,C,
4076,Anfernee Simons,2019,2022,3,G,
4077,Dickey Simpkins,1995,2002,7,F,
4078,Ralph Simpson,1971,1980,9,G,F
4079,Alvin Sims,1999,1999,0,G,
4080,Bob Sims,1962,1968,6,G,F
4081,Courtney Sims,2008,2009,1,C,
4082,Doug Sims,1969,1969,0,F,
4083,Henry Sims,2013,2016,3,C,
4084,Jericho Sims,2022,2022,0,F,
4085,Scott Sims,1978,1978,0,G,
4086,Kyle Singler,2013,2018,5,F,
4087,Sean Singletary,2009,2009,0,G,
4088,Chris Singleton,2012,2014,2,F,
4089,James Singleton,2006,2012,6,F,
4090,McKinley Singleton,1987,1987,0,G,
4091,Zeke Sinicola,1952,1954,2,G,
4092,Deividas Sirvydis,2021,2022,1,G,F
4093,Charlie Sitton,1985,1985,0,F,
4094,Peyton Siva,2014,2014,0,G,
4095,Scott Skiles,1987,1996,9,G,
4096,Al Skinner,1975,1980,5,G,
4097,Brian Skinner,1999,2012,13,F,
4098,Tal Skinner,1975,1976,1,F,G
4099,Whitey Skoog,1952,1957,5,G,
4100,Jeff Slade,1963,1963,0,F,
4101,Reggie Slater,1995,2003,8,F,
4102,Jim Slaughter,1952,1952,0,C,
4103,Jose Slaughter,1983,1983,0,G,
4104,Tamar Slay,2003,2005,2,G,
4105,Donald Sloan,2012,2016,4,G,
4106,Jerry Sloan*,1966,1976,10,G,F
4107,Uroš Slokar,2007,2007,0,F,
4108,Tom Sluby,1985,1985,0,G,
4109,Alen Smailagić,2020,2021,1,F,
4110,Javonte Smart,2022,2022,0,G,
4111,Keith Smart,1989,1989,0,G,
4112,Marcus Smart,2015,2022,7,G,
4113,Belus Smawley,1947,1952,5,G,F
4114,Jack Smiley,1949,1950,1,F,G
4115,Adrian Smith,1962,1972,10,G,
4116,Al Smith,1972,1976,4,G,
4117,Bill Smith,1962,1962,0,G,F
4118,Bingo Smith,1970,1980,10,F,G
4119,Bobby Smith,1960,1962,2,G,
4120,Charles Smith,1989,1997,8,F,C
4121,Charles Smith,1990,1996,6,G,
4122,Charles Smith,1998,2006,8,G,
4123,Chris Smith,1993,1995,2,G,
4124,Chris Smith,2014,2014,0,G,
4125,Clinton Smith,1987,1991,4,F,
4126,Craig Smith,2007,2012,5,F,
4127,Deb Smith,1947,1947,0,F,
4128,Dennis Smith Jr.,2018,2022,4,G,
4129,Derek Smith,1983,1991,8,G,F
4130,Don Smith,1949,1949,0,G,F
4131,Don Smith,1975,1975,0,G,
4132,Donta Smith,2005,2006,1,G,F
4133,Doug Smith,1992,1996,4,F,
4134,Ed Smith,1954,1954,0,F,
4135,Elmore Smith,1972,1979,7,C,
4136,Garfield Smith,1971,1973,2,C,F
4137,Greg Smith,1969,1976,7,F,
4138,Greg Smith,2012,2016,4,C,
4139,Ish Smith,2011,2022,11,G,
4140,J.R. Smith,2005,2020,15,G,F
4141,Jabari Smith,2001,2005,4,C,
4142,Jalen Smith,2021,2022,1,F,
4143,Jason Smith,2008,2019,11,F,C
4144,Jerry Smith,2012,2012,0,G,
4145,Jim Smith,1982,1983,1,F,
4146,Joe Smith,1996,2011,15,F,
4147,John Smith,1969,1970,1,C,
4148,Josh Smith,2005,2018,13,F,
4149,Keith Smith,1987,1987,0,G,
4150,Ken Smith,1976,1976,0,F,
4151,Kenny Smith,1988,1997,9,G,
4152,LaBradford Smith,1992,1994,2,G,
4153,Larry Smith,1981,1993,12,F,C
4154,Leon Smith,2002,2004,2,C,
4155,Michael Smith,1990,1995,5,F,
4156,Michael Smith,1995,2001,6,F,
4157,Mike Smith,2001,2001,0,F,
4158,Nolan Smith,2012,2013,1,G,
4159,Otis Smith,1987,1992,5,G,F
4160,Pete Smith,1973,1973,0,F,
4161,Phil Smith,1975,1983,8,G,
4162,Randy Smith,1972,1983,11,G,F
4163,Reggie Smith,1993,1994,1,C,
4164,Robert Smith,1978,1985,7,G,
4165,Russ Smith,2015,2016,1,G,
4166,Sam Smith,1968,1971,3,F,
4167,Sam Smith,1979,1980,1,G,
4168,Steve Smith,1992,2005,13,G,
4169,Steven Smith,2007,2007,0,F,
4170,Stevin Smith,1997,1997,0,G,
4171,Theron Smith,2004,2005,1,F,
4172,Tony Smith,1991,2001,10,G,
4173,William Smith,1972,1973,1,C,
4174,Willie Smith,1977,1980,3,G,
4175,Zhaire Smith,2019,2020,1,G,
4176,Rik Smits,1989,2000,11,C,
4177,Mike Smrek,1986,1992,6,C,
4178,Joe Smyth,1954,1954,0,F,
4179,Xavier Sneed,2022,2022,0,F,
4180,Tony Snell,2014,2022,8,G,F
4181,Eric Snow,1996,2008,12,G,
4182,Dick Snyder,1967,1979,12,G,F
4183,Kirk Snyder,2005,2008,3,G,
4184,Chips Sobek,1950,1950,0,G,F
4185,Ricky Sobers,1976,1986,10,G,
4186,Ron Sobie,1957,1960,3,G,
4187,Mike Sojourner,1975,1977,2,C,F
4188,Willie Sojourner,1972,1975,3,C,F
4189,Will Solomon,2002,2009,7,G,
4190,Willie Somerset,1966,1969,3,G,
4191,Darius Songaila,2004,2011,7,F,
4192,Dave Sorenson,1971,1973,2,F,
4193,James Southerland,2014,2014,0,F,
4194,Gino Sovran,1947,1947,0,F,G
4195,Pape Sow,2005,2007,2,F,
4196,Ken Spain,1971,1971,0,C,
4197,Ray Spalding,2019,2021,2,F,
4198,Jim Spanarkel,1980,1984,4,G,F
4199,Vassilis Spanoulis,2007,2007,0,G,
4200,Daniel Sparks,1969,1970,1,F,
4201,Guy Sparrow,1958,1960,2,F,
4202,Rory Sparrow,1981,1992,11,G,
4203,Odie Spears,1949,1957,8,G,
4204,Art Spector,1947,1950,3,F,
4205,Marreese Speights,2009,2018,9,C,F
4206,Omari Spellman,2019,2020,1,F,
4207,Andre Spencer,1993,1994,1,F,
4208,Elmore Spencer,1993,1997,4,C,
4209,Felton Spencer,1991,2002,11,C,
4210,Lou Spicer,1947,1947,0,F,
4211,Craig Spitzer,1968,1968,0,C,
4212,Tiago Splitter,2011,2017,6,F,C
4213,Art Spoelstra,1955,1958,3,C,
4214,Bruce Spraggins,1968,1968,0,F,
4215,Latrell Sprewell,1993,2005,12,G,
4216,Larry Spriggs,1982,1986,4,F,
4217,Jaden Springer,2022,2022,0,G,
4218,Jim Springer,1949,1949,0,C,
4219,Jim Spruill,1949,1949,0,G,
4220,Ryan Stack,1999,2000,1,F,
4221,Jerry Stackhouse,1996,2013,17,G,F
4222,Kevin Stacom,1975,1982,7,G,
4223,Erv Staggs,1970,1970,0,F,G
4224,Bud Stallworth,1973,1977,4,F,G
4225,Dave Stallworth,1966,1975,9,F,C
4226,Ed Stanczak,1950,1951,1,F,
4227,Cassius Stanley,2021,2022,1,G,
4228,Terence Stansbury,1985,1987,2,G,
4229,John Starks,1989,2002,13,G,
4230,Keith Starr,1977,1977,0,G,F
4231,Nik Stauskas,2015,2022,7,G,
4232,Larry Staverman,1959,1964,5,F,
4233,Larry Steele,1972,1980,8,G,F
4234,Matt Steigenga,1997,1997,0,F,
4235,Vladimir Stepania,1999,2004,5,C,
4236,D.J. Stephens,2014,2019,5,G,F
4237,Everette Stephens,1989,1991,2,G,
4238,Jack Stephens,1956,1956,0,G,F
4239,Joe Stephens,1997,2000,3,F,
4240,Lance Stephenson,2011,2022,11,G,F
4241,Alex Stepheson,2016,2016,0,F,
4242,Brook Steppe,1983,1989,6,G,F
4243,Barry Stevens,1993,1993,0,G,F
4244,Lamar Stevens,2021,2022,1,F,
4245,Wayne Stevens,1960,1960,0,F,
4246,DeShawn Stevenson,2001,2013,12,G,
4247,Dennis Stewart,1971,1971,0,F,
4248,Isaiah Stewart,2021,2022,1,F,C
4249,Kebu Stewart,1998,1998,0,F,
4250,Larry Stewart,1992,1997,5,F,
4251,Michael Stewart,1998,2005,7,C,
4252,Norm Stewart,1957,1957,0,F,
4253,Greg Stiemsma,2012,2015,3,C,
4254,Steve Stipanovich,1984,1988,4,C,
4255,Bryant Stith,1993,2002,9,G,
4256,Sam Stith,1962,1962,0,G,
4257,Tom Stith,1963,1963,0,F,
4258,Alex Stivrins,1986,1993,7,F,
4259,David Stockton,2015,2018,3,G,
4260,John Stockton*,1985,2003,18,G,
4261,Peja Stojaković,1999,2011,12,F,
4262,Ed Stokes,1998,1998,0,C,
4263,Greg Stokes,1986,1990,4,F,C
4264,Jarnell Stokes,2015,2017,2,F,C
4265,Maurice Stokes*,1956,1958,2,F,C
4266,Art Stolkey,1947,1947,0,G,
4267,Randy Stoll,1968,1968,0,C,
4268,Diamond Stone,2017,2017,0,C,
4269,George Stone,1969,1972,3,F,
4270,Julyan Stone,2012,2018,6,G,
4271,Awvee Storey,2005,2008,3,G,F
4272,Damon Stoudamire,1996,2008,12,G,
4273,Salim Stoudamire,2006,2008,2,G,
4274,Amar'e Stoudemire,2003,2016,13,F,C
4275,Paul Stovall,1973,1974,1,F,
4276,D.J. Strawberry,2008,2008,0,G,
4277,Joe Strawder,1966,1968,2,C,
4278,Bill Stricker,1971,1971,0,F,
4279,Erick Strickland,1997,2005,8,G,
4280,Mark Strickland,1995,2003,8,F,
4281,Rod Strickland,1989,2005,16,G,
4282,Roger Strickland,1964,1964,0,F,
4283,John Stroeder,1988,1989,1,F,
4284,Derek Strong,1992,2001,9,F,
4285,Lamont Strothers,1992,1993,1,G,
4286,John Stroud,1981,1981,0,F,
4287,Red Stroud,1968,1968,0,G,
4288,Max Strus,2020,2022,2,G,
4289,Rodney Stuckey,2008,2017,9,G,
4290,Gene Stump,1948,1950,2,F,G
4291,Stan Stutz,1947,1949,2,G,F
4292,Jalen Suggs,2022,2022,0,G,
4293,Gary Suiter,1971,1971,0,C,F
4294,Jared Sullinger,2013,2017,4,F,
4295,DaJuan Summers,2010,2013,3,F,
4296,Edmond Sumner,2018,2021,3,G,
4297,Barry Sumpter,1989,1989,0,F,C
4298,Don Sunderlage,1954,1955,1,G,
4299,Bruno Šundov,1999,2005,6,C,
4300,Jon Sundvold,1984,1992,8,G,
4301,Bob Sura,1996,2005,9,G,
4302,Dick Surhoff,1953,1954,1,F,
4303,George Sutor,1968,1970,2,C,
4304,Dane Suttle,1984,1985,1,G,
4305,Greg Sutton,1992,1996,4,G,
4306,Keith Swagerty,1969,1970,1,F,
4307,Bennie Swain,1959,1959,0,F,
4308,Caleb Swanigan,2018,2020,2,F,
4309,Norm Swanson,1954,1954,0,F,
4310,Dan Swartz,1963,1963,0,F,
4311,Mike Sweetney,2004,2007,3,F,
4312,Robert Swift,2005,2009,4,C,
4313,Skeeter Swift,1970,1974,4,G,
4314,Stromile Swift,2001,2009,8,F,
4315,Aaron Swinson,1995,1995,0,F,
4316,Craig Sword,2022,2022,0,G,
4317,Pape Sy,2011,2011,0,F,
4318,Buck Sydnor,1947,1947,0,G,
4319,Keifer Sykes,2022,2022,0,G,
4320,Larry Sykes,1996,1996,0,F,
4321,Brett Szabo,1997,1997,0,C,
4322,Wally Szczerbiak,2000,2009,9,F,
4323,Walt Szczerbiak,1972,1972,0,F,
4324,Žan Tabak,1995,2001,6,C,
4325,Yuta Tabuse,2005,2005,0,G,
4326,Chris Taft,2006,2006,0,F,
4327,Sid Tanenbaum,1948,1949,1,G,
4328,Dragan Tarlać,2001,2001,0,C,
4329,Roy Tarpley,1987,1995,8,C,F
4330,Levern Tart,1968,1971,3,G,F
4331,Jae'Sean Tate,2021,2022,1,F,
4332,Earl Tatum,1977,1980,3,G,F
4333,Jayson Tatum,2018,2022,4,F,
4334,Edy Tavares,2016,2017,1,C,
4335,Anthony Taylor,1989,1989,0,G,
4336,Brian Taylor,1973,1982,9,G,
4337,Donell Taylor,2006,2007,1,G,
4338,Fatty Taylor,1970,1977,7,G,
4339,Fred Taylor,1971,1972,1,G,F
4340,Isaiah Taylor,2017,2018,1,G,
4341,Jay Taylor,1990,1990,0,G,
4342,Jeff Taylor,1983,1987,4,G,
4343,Jeff Taylor,2013,2015,2,F,
4344,Jermaine Taylor,2010,2011,1,G,
4345,Johnny Taylor,1998,2000,2,F,
4346,Leonard Taylor,1990,1990,0,F,
4347,Maurice Taylor,1998,2007,9,F,
4348,Mike Taylor,2009,2009,0,G,
4349,Oliver Taylor,1971,1974,3,G,F
4350,Ronald Taylor,1970,1972,2,C,
4351,Terry Taylor,2022,2022,0,G,F
4352,Tyshawn Taylor,2013,2014,1,G,
4353,Vince Taylor,1983,1983,0,G,F
4354,Terry Teagle,1983,1993,10,F,G
4355,Jeff Teague,2010,2021,11,G,
4356,Marquis Teague,2013,2018,5,G,
4357,Mirza Teletović,2013,2018,5,F,
4358,Sebastian Telfair,2005,2015,10,G,
4359,Collis Temple,1975,1975,0,F,
4360,Garrett Temple,2010,2022,12,G,
4361,Miloš Teodosić,2018,2019,1,G,
4362,Ira Terrell,1977,1979,2,F,C
4363,Jared Terrell,2019,2019,0,G,
4364,Carlos Terry,1981,1983,2,G,F
4365,Chuck Terry,1973,1977,4,F,
4366,Claude Terry,1973,1978,5,G,F
4367,Emanuel Terry,2019,2022,3,F,
4368,Jason Terry,2000,2018,18,G,
4369,Tyrell Terry,2021,2022,1,G,
4370,Jon Teske,2022,2022,0,C,
4371,Hasheem Thabeet,2010,2014,4,C,
4372,Tom Thacker,1964,1971,7,G,F
4373,Floyd Theard,1970,1970,0,G,
4374,Daniel Theis,2018,2022,4,C,
4375,Reggie Theus,1979,1991,12,G,
4376,Peter Thibeaux,1985,1986,1,F,
4377,Bill Thieben,1957,1958,1,F,C
4378,Justus Thigpen,1970,1974,4,G,
4379,David Thirdkill,1983,1987,4,F,G
4380,Adonis Thomas,2014,2014,0,F,
4381,Billy Thomas,2005,2008,3,G,
4382,Brodric Thomas,2021,2022,1,G,
4383,Cam Thomas,2022,2022,0,G,
4384,Carl Thomas,1992,1998,6,G,
4385,Charles Thomas,1992,1992,0,G,
4386,Etan Thomas,2002,2011,9,F,
4387,Irving Thomas,1991,1991,0,F,
4388,Isaiah Thomas,2012,2022,10,G,
4389,Isiah Thomas*,1982,1994,12,G,
4390,Jamel Thomas,2000,2001,1,F,
4391,James Thomas,2005,2006,1,F,
4392,Jim Thomas,1984,1991,7,G,
4393,Joe Thomas,1971,1971,0,F,
4394,John Thomas,1998,2006,8,F,
4395,Kenny Thomas,2000,2010,10,F,
4396,Khyri Thomas,2019,2021,2,G,
4397,Kurt Thomas,1996,2013,17,F,
4398,Lance Thomas,2012,2020,8,F,
4399,Malcolm Thomas,2012,2015,3,F,
4400,Matt Thomas,2020,2022,2,G,
4401,Ronald Thomas,1973,1976,3,F,
4402,Terry Thomas,1976,1976,0,F,
4403,Tim Thomas,1998,2010,12,F,
4404,Tyrus Thomas,2007,2015,8,F,
4405,Willis Thomas,1968,1968,0,G,
4406,Trey Thompkins,2012,2012,0,F,
4407,Bernard Thompson,1985,1989,4,F,G
4408,Billy Thompson,1987,1992,5,F,
4409,Brooks Thompson,1995,1998,3,G,
4410,Corny Thompson,1983,1983,0,F,
4411,David Thompson*,1976,1984,8,G,F
4412,Dijon Thompson,2006,2007,1,G,F
4413,George Thompson,1970,1975,5,G,
4414,Hollis Thompson,2014,2017,3,G,F
4415,Jack Thompson,1969,1969,0,G,
4416,Jason Thompson,2009,2016,7,F,C
4417,John Thompson*,1965,1966,1,F,
4418,Kevin Thompson,1994,1994,0,C,F
4419,Klay Thompson,2012,2022,10,G,F
4420,LaSalle Thompson,1983,1997,14,C,F
4421,Mychal Thompson,1979,1991,12,C,F
4422,Mychel Thompson,2012,2012,0,G,
4423,Paul Thompson,1984,1986,2,G,F
4424,Stephen Thompson,1992,1992,0,G,
4425,Tristan Thompson,2012,2022,10,F,C
4426,JT Thor,2022,2022,0,F,
4427,Skip Thoren,1968,1970,2,C,
4428,Rod Thorn*,1964,1971,7,G,
4429,Al Thornton,2008,2011,3,F,
4430,Bob Thornton,1986,1996,10,F,C
4431,Dallas Thornton,1969,1970,1,G,
4432,Marcus Thornton,2010,2017,7,G,
4433,Sindarius Thornwell,2018,2021,3,G,
4434,Otis Thorpe,1985,2001,16,F,C
4435,Sedale Threatt,1984,1997,13,G,
4436,Nate Thurmond*,1964,1977,13,C,F
4437,Mel Thurston,1948,1948,0,G,
4438,Matisse Thybulle,2020,2022,2,G,
4439,Hal Tidrick,1949,1949,0,F,G
4440,Dan Tieman,1963,1963,0,G,
4441,Killian Tillie,2021,2022,1,F,
4442,Darren Tillis,1983,1984,1,C,F
4443,Xavier Tillman Sr.,2021,2022,1,F,
4444,Jack Tingle,1948,1949,1,F,
4445,George Tinsley,1970,1972,2,F,
4446,Jamaal Tinsley,2002,2014,12,G,
4447,Wayman Tisdale,1986,1997,11,F,C
4448,Mike Tobey,2017,2017,0,C,
4449,Isaiah Todd,2022,2022,0,F,
4450,Mike Todorovich,1950,1951,1,F,C
4451,Ray Tolbert,1982,1989,7,F,
4452,Tom Tolbert,1989,1995,6,F,C
4453,Anthony Tolliver,2009,2021,12,F,C
4454,Dean Tolson,1975,1978,3,F,
4455,Rudy Tomjanovich*,1971,1981,10,F,
4456,Andrew Toney,1981,1988,7,G,
4457,Sedric Toney,1986,1994,8,G,
4458,Andy Tonkovich,1949,1949,0,G,
4459,Andy Toolson,1991,1996,5,G,F
4460,Jack Toomay,1948,1950,2,C,F
4461,Bernard Toone,1980,1980,0,F,
4462,Obi Toppin,2021,2022,1,F,
4463,Irv Torgoff,1947,1949,2,F,
4464,Gene Tormohlen,1963,1970,7,C,F
4465,Óscar Torres,2002,2003,1,F,
4466,Juan Toscano-Anderson,2020,2022,2,F,
4467,Bill Tosheff,1952,1954,2,G,
4468,Bob Tough,1949,1950,1,G,F
4469,Axel Toupane,2016,2021,5,G,F
4470,Monte Towe,1976,1977,1,G,
4471,Keith Tower,1994,1997,3,C,F
4472,Blackie Towery,1949,1950,1,F,C
4473,Linton Townes,1983,1985,2,F,G
4474,Karl-Anthony Towns,2016,2022,6,C,F
4475,Raymond Townsend,1979,1982,3,G,
4476,George Trapp,1972,1977,5,F,C
4477,John Trapp,1969,1973,4,F,
4478,Robert Traylor,1999,2005,6,F,
4479,Gary Trent,1996,2004,8,F,
4480,Gary Trent Jr.,2019,2022,3,G,
4481,Jeff Trepagnier,2002,2004,2,G,
4482,John Tresvant,1965,1973,8,F,C
4483,Allonzo Trier,2019,2020,1,G,
4484,Dick Triptow,1949,1950,1,G,F
4485,Kelly Tripucka,1982,1991,9,F,G
4486,Ansley Truitt,1973,1973,0,C,
4487,Cezary Trybański,2003,2004,1,C,
4488,Jake Tsakalidis,2001,2007,6,C,
4489,John Tschogl,1973,1975,2,F,
4490,Lou Tsioropoulos,1957,1959,2,F,
4491,Nikoloz Tskitishvili,2003,2006,3,F,
4492,Al Tucker,1968,1972,4,F,
4493,Alando Tucker,2008,2010,2,F,
4494,Anthony Tucker,1995,1995,0,F,
4495,Jim Tucker,1955,1957,2,F,
4496,P.J. Tucker,2007,2022,15,F,
4497,Rayjon Tucker,2020,2022,2,F,
4498,Trent Tucker,1983,1993,10,G,
4499,Ronny Turiaf,2006,2015,9,F,
4500,Mirsad Türkcan,2000,2000,0,F,
4501,Hedo Türkoğlu,2001,2015,14,F,
4502,Andre Turner,1987,1992,5,G,
4503,Bill Turner,1968,1973,5,F,
4504,Elston Turner,1982,1989,7,G,F
4505,Evan Turner,2011,2020,9,G,
4506,Gary Turner,1968,1968,0,F,
4507,Henry Turner,1990,1995,5,G,F
4508,Herschell Turner,1968,1968,0,G,
4509,Jack Turner,1955,1955,0,F,G
4510,Jack Turner,1962,1962,0,G,F
4511,Jeff Turner,1985,1996,11,F,C
4512,John Turner,1992,1992,0,F,
4513,Myles Turner,2016,2022,6,C,F
4514,Wayne Turner,2000,2000,0,G,
4515,Melvin Turpin,1985,1990,5,C,
4516,Dave Twardzik,1973,1980,7,G,
4517,Jack Twyman*,1956,1966,10,F,G
4518,B.J. Tyler,1995,1995,0,G,
4519,Jeremy Tyler,2012,2014,2,C,
4520,Terry Tyler,1979,1989,10,F,G
4521,Charlie Tyra,1958,1962,4,C,F
4522,Edwin Ubiles,2012,2012,0,G,
4523,Ekpe Udoh,2011,2019,8,C,F
4524,Ime Udoka,2004,2011,7,F,
4525,Beno Udrih,2005,2017,12,G,
4526,Roko Ukić,2009,2010,1,G,
4527,Tyler Ulis,2017,2019,2,G,
4528,Wes Unseld*,1969,1981,12,C,F
4529,Hal Uplinger,1954,1954,0,G,
4530,Kelvin Upshaw,1989,1991,2,G,
4531,Jarrod Uthoff,2017,2020,3,F,
4532,Ben Uzoh,2011,2012,1,G,
4533,Stephen Vacendak,1968,1970,2,G,
4534,Jonas Valančiūnas,2013,2022,9,C,
4535,Darnell Valentine,1982,1991,9,G,
4536,Denzel Valentine,2017,2022,5,G,
4537,Ronnie Valentine,1981,1981,0,F,
4538,John Vallely,1971,1972,1,G,
4539,Dick Van Arsdale,1966,1977,11,G,F
4540,Tom Van Arsdale,1966,1977,11,F,G
4541,Nick Van Exel,1994,2006,12,G,
4542,Keith Van Horn,1998,2006,8,F,
4543,Norm Van Lier,1970,1979,9,G,
4544,Dennis Van Zant,1976,1976,0,F,
4545,Fred VanVleet,2017,2022,5,G,
4546,Gene Vance,1948,1952,4,G,F
4547,Logan Vander Velden,1996,1996,0,F,
4548,Jarred Vanderbilt,2019,2022,3,F,
4549,Ernie Vandeweghe,1950,1956,6,F,G
4550,Kiki Vandeweghe,1981,1993,12,F,
4551,Nick Vanos,1986,1987,1,C,
4552,David Vanterpool,2001,2001,0,G,
4553,Ratko Varda,2002,2002,0,C,
4554,Anderson Varejão,2005,2021,16,F,C
4555,Jarvis Varnado,2013,2014,1,F,
4556,Greivis Vásquez,2011,2017,6,G,
4557,Devin Vassell,2021,2022,1,G,F
4558,Chico Vaughn,1963,1970,7,G,
4559,David Vaughn,1975,1976,1,C,
4560,David Vaughn,1996,1999,3,F,
4561,Jacque Vaughn,1998,2009,11,G,
4562,Rashad Vaughn,2016,2018,2,G,
4563,Virgil Vaughn,1947,1947,0,F,C
4564,Loy Vaught,1991,2001,10,F,
4565,Bob Verga,1968,1974,6,G,
4566,Pete Verhoeven,1982,1987,5,F,
4567,Jan Veselý,2012,2014,2,F,
4568,Gundars Vētra,1993,1993,0,F,
4569,João Vianna,1992,1992,0,F,
4570,Charlie Villanueva,2006,2016,10,F,
4571,Gabe Vincent,2020,2022,2,G,
4572,Jay Vincent,1982,1990,8,F,
4573,Sam Vincent,1986,1992,6,G,
4574,Marcus Vinicius,2007,2008,1,F,
4575,Fred Vinson,1995,2000,5,G,
4576,Claude Virden,1973,1973,0,F,
4577,Gary Voce,1990,1990,0,F,
4578,Floyd Volker,1950,1950,0,F,C
4579,Alexander Volkov,1990,1992,2,C,
4580,Whitey Von Nieda,1950,1950,0,G,F
4581,Noah Vonleh,2015,2021,6,F,
4582,Jake Voskuhl,2001,2009,8,C,
4583,Danny Vranes,1982,1988,6,F,
4584,Slavko Vraneš,2004,2004,0,C,
4585,Stojko Vranković,1991,1999,8,C,
4586,Brett Vroman,1981,1981,0,C,
4587,Jackson Vroman,2005,2006,1,F,C
4588,Nikola Vučević,2012,2022,10,C,
4589,Sasha Vujačić,2005,2017,12,G,
4590,Butch van Breda Kolff,1947,1950,3,G,F
4591,Jan van Breda Kolff,1975,1983,8,F,G
4592,Dean Wade,2020,2022,2,F,
4593,Dwyane Wade,2004,2019,15,G,
4594,Mark Wade,1988,1990,2,G,
4595,Von Wafer,2006,2012,6,G,
4596,Clint Wager,1950,1950,0,C,F
4597,Dajuan Wagner,2003,2007,4,G,
4598,Danny Wagner,1950,1950,0,G,
4599,Franz Wagner,2022,2022,0,G,F
4600,Milt Wagner,1988,1991,3,G,
4601,Moritz Wagner,2019,2022,3,F,C
4602,Phillip Wagner,1969,1969,0,G,
4603,Ish Wainright,2022,2022,0,F,
4604,Dion Waiters,2013,2020,7,G,
4605,Granville Waiters,1984,1988,4,C,
4606,Andre Wakefield,1979,1980,1,G,
4607,Neal Walk,1970,1977,7,C,
4608,Andy Walker,1977,1977,0,G,
4609,Antoine Walker,1997,2008,11,F,
4610,Brady Walker,1949,1952,3,F,C
4611,Chet Walker*,1963,1975,12,F,G
4612,Darrell Walker,1984,1993,9,G,
4613,Foots Walker,1975,1984,9,G,
4614,Henry Walker,2009,2015,6,F,
4615,Horace Walker,1962,1962,0,F,
4616,Jimmy Walker,1968,1976,8,G,
4617,Kemba Walker,2012,2022,10,G,
4618,Kenny Walker,1987,1995,8,F,
4619,Lonnie Walker IV,2019,2022,3,G,
4620,M.J. Walker,2022,2022,0,G,
4621,Phil Walker,1978,1978,0,G,
4622,Samaki Walker,1997,2006,9,F,
4623,Wally Walker,1977,1984,7,F,
4624,John Wall,2011,2021,10,G,
4625,Ben Wallace*,1997,2012,15,F,C
4626,Gerald Wallace,2002,2015,13,F,
4627,John Wallace,1997,2004,7,F,
4628,Rasheed Wallace,1996,2013,17,F,C
4629,Red Wallace,1947,1947,0,G,
4630,Tyrone Wallace,2018,2020,2,G,
4631,Dwight Waller,1969,1972,3,F,
4632,Jamie Waller,1988,1988,0,G,
4633,Jim Walsh,1958,1958,0,F,
4634,Matt Walsh,2006,2006,0,G,F
4635,Rex Walters,1994,2000,6,G,
4636,Paul Walther,1950,1955,5,G,F
4637,Isaac Walthour,1954,1954,0,G,
4638,Bill Walton*,1975,1987,12,C,F
4639,Derrick Walton,2018,2022,4,G,
4640,Lloyd Walton,1977,1981,4,G,
4641,Luke Walton,2004,2013,9,F,
4642,Brad Wanamaker,2019,2022,3,G,
4643,Bobby Wanzer*,1949,1957,8,G,
4644,Perry Warbington,1975,1975,0,G,
4645,Charlie Ward,1995,2005,10,G,
4646,Gerry Ward,1964,1967,3,G,
4647,Henry Ward,1976,1977,1,G,F
4648,Casper Ware,2014,2014,0,G,
4649,Jim Ware,1967,1969,2,F,
4650,Ben Warley,1963,1970,7,F,G
4651,Bob Warlick,1966,1970,4,G,F
4652,Cornell Warner,1971,1977,6,F,C
4653,Jameel Warney,2018,2018,0,F,
4654,Bob Warren,1969,1976,7,G,
4655,John Warren,1970,1974,4,G,F
4656,T.J. Warren,2015,2021,6,F,
4657,Willie Warren,2011,2011,0,G,
4658,Bryan Warrick,1983,1986,3,G,
4659,Hakim Warrick,2006,2013,7,F,
4660,Chris Washburn,1987,1988,1,C,
4661,Julian Washburn,2019,2019,0,F,
4662,Bobby Washington,1970,1972,2,G,
4663,Darius Washington,2008,2008,0,G,
4664,Donald Washington,1975,1976,1,F,
4665,Duane Washington,1988,1993,5,G,
4666,Duane Washington Jr.,2022,2022,0,G,
4667,Eric Washington,1998,1999,1,G,
4668,Jim Washington,1966,1976,10,F,C
4669,Kermit Washington,1974,1988,14,F,C
4670,P.J. Washington,2020,2022,2,F,
4671,Pearl Washington,1987,1989,2,G,
4672,Richard Washington,1977,1982,5,F,C
4673,Stan Washington,1975,1975,0,G,
4674,Trooper Washington,1968,1973,5,F,C
4675,Wilson Washington,1978,1979,1,F,C
4676,Yuta Watanabe,2019,2022,3,F,
4677,Lindy Waters III,2022,2022,0,G,
4678,Tremont Waters,2020,2022,2,G,
4679,Trendon Watford,2022,2022,0,F,
4680,Darryl Watkins,2008,2012,4,C,
4681,Bobby Watson,1955,1955,0,G,
4682,C.J. Watson,2008,2017,9,G,
4683,Earl Watson,2002,2014,12,G,
4684,Jamie Watson,1995,1999,4,F,
4685,Paul Watson,2020,2022,2,G,
4686,Ron Watts,1966,1967,1,F,
4687,Samuel Watts,1971,1971,0,G,
4688,Slick Watts,1974,1979,5,G,
4689,Maalik Wayns,2013,2014,1,G,
4690,David Wear,2015,2015,0,F,
4691,Travis Wear,2015,2018,3,F,
4692,Clarence Weatherspoon,1993,2005,12,F,
4693,Nick Weatherspoon,1974,1980,6,F,
4694,Quinndary Weatherspoon,2020,2022,2,G,
4695,Kyle Weaver,2009,2011,2,G,
4696,James Webb III,2018,2018,0,F,
4697,Jeff Webb,1971,1972,1,G,
4698,Marcus Webb,1993,1993,0,F,C
4699,Spud Webb,1986,1998,12,G,
4700,Chris Webber*,1994,2008,14,F,C
4701,Briante Weber,2016,2018,2,G,
4702,Jake Weber,1947,1947,0,C,
4703,Elnardo Webster,1972,1972,0,F,
4704,Jeff Webster,1996,1996,0,F,
4705,Martell Webster,2006,2015,9,G,F
4706,Marvin Webster,1976,1987,11,C,
4707,Scott Wedman,1975,1987,12,F,G
4708,Sonny Weems,2009,2016,7,G,F
4709,Dick Wehr,1949,1949,0,F,
4710,Brant Weidner,1984,1984,0,F,
4711,Bob Weiss,1966,1977,11,G,
4712,Rick Weitzman,1968,1968,0,G,
4713,Bonzi Wells,1999,2008,9,G,F
4714,Bubba Wells,1998,1998,0,F,
4715,Owen Wells,1975,1975,0,F,
4716,Ralph Wells,1963,1963,0,G,
4717,Chris Welp,1988,1990,2,C,
4718,Jiří Welsch,2003,2006,3,G,
4719,Thomas Welsh,2019,2019,0,C,
4720,Bill Wennington,1986,2000,14,C,
4721,Matt Wenstrom,1994,1994,0,C,
4722,Robert Werdann,1993,1997,4,C,
4723,Ray Wertis,1947,1948,1,G,
4724,David Wesley,1994,2007,13,G,
4725,Walt Wesley,1967,1976,9,C,
4726,David West,2004,2018,14,F,C
4727,Delonte West,2005,2012,7,G,
4728,Doug West,1990,2001,11,G,F
4729,Jerry West*,1961,1974,13,G,
4730,Mario West,2008,2011,3,G,
4731,Mark West,1984,2000,16,C,F
4732,Roland West,1968,1968,0,G,
4733,Dexter Westbrook,1968,1968,0,F,
4734,Russell Westbrook,2009,2022,13,G,
4735,Paul Westphal*,1973,1984,11,G,
4736,John Wetzel,1968,1976,8,G,F
4737,Robert Whaley,2006,2006,0,C,
4738,Ennis Whatley,1984,1997,13,G,
4739,DeJuan Wheat,1998,1999,1,G,
4740,Clinton Wheeler,1988,1989,1,G,
4741,Tyson Wheeler,1999,1999,0,G,
4742,Skippy Whitaker,1955,1955,0,G,
4743,Andrew White,2018,2018,0,G,
4744,Coby White,2020,2022,2,G,
4745,D.J. White,2009,2014,5,F,
4746,Derrick White,2018,2022,4,G,
4747,Eric White,1988,1989,1,F,
4748,Herb White,1971,1971,0,G,
4749,Hubie White,1963,1971,8,G,F
4750,Jahidi White,1999,2005,6,F,C
4751,James White,2007,2013,6,G,F
4752,Jo Jo White*,1970,1981,11,G,
4753,Okaro White,2017,2019,2,F,
4754,Randy White,1990,1994,4,F,
4755,Rodney White,2002,2005,3,F,
4756,Rory White,1983,1987,4,F,
4757,Royce White,2014,2014,0,F,
4758,Rudy White,1976,1981,5,G,
4759,Tony White,1988,1988,0,G,
4760,Willie White,1985,1986,1,G,
4761,Isaiah Whitehead,2017,2018,1,G,
4762,Jerome Whitehead,1979,1989,10,C,F
4763,Donald Whiteside,1997,1998,1,G,
4764,Hassan Whiteside,2011,2022,11,C,
4765,Dwayne Whitfield,1996,1996,0,F,
4766,Chris Whitney,1994,2004,10,G,
4767,Hank Whitney,1968,1970,2,F,C
4768,Hawkeye Whitney,1981,1982,1,G,F
4769,Greg Whittington,2021,2021,0,F,
4770,Shayne Whittington,2015,2016,1,F,C
4771,Sidney Wicks,1972,1981,9,F,C
4772,Ron Widby,1968,1968,0,F,
4773,Murray Wier,1950,1950,0,G,
4774,Bob Wiesenhahn,1962,1962,0,F,
4775,Joe Wieskamp,2022,2022,0,G,
4776,Aaron Wiggins,2022,2022,0,G,
4777,Andrew Wiggins,2015,2022,7,F,G
4778,Mitchell Wiggins,1984,1992,8,G,
4779,Lindell Wigginton,2022,2022,0,G,
4780,Ken Wilburn,1968,1969,1,F,
4781,C.J. Wilcox,2015,2017,2,G,
4782,Chris Wilcox,2003,2013,10,F,
4783,D.C. Wilcutt,1949,1950,1,G,
4784,Gene Wiley,1963,1968,5,C,
4785,Jacob Wiley,2018,2018,0,F,
4786,Michael Wiley,1981,1982,1,F,
4787,Morlon Wiley,1989,1995,6,G,
4788,Win Wilfong,1958,1961,3,G,F
4789,Lenny Wilkens*,1961,1975,14,G,
4790,Bob Wilkerson,1977,1983,6,G,F
4791,Jamaal Wilkes*,1975,1986,11,F,G
4792,James Wilkes,1981,1983,2,F,
4793,Damien Wilkins,2005,2018,13,F,G
4794,Dominique Wilkins*,1983,1999,16,F,G
4795,Eddie Lee Wilkins,1985,1993,8,F,C
4796,Gerald Wilkins,1986,1999,13,G,F
4797,Jeff Wilkins,1981,1986,5,C,F
4798,Dale Wilkinson,1985,1985,0,F,
4799,Mike Wilks,2003,2010,7,G,
4800,Aaron Williams,1994,2008,14,F,C
4801,Al Williams,1971,1971,0,F,
4802,Alan Williams,2016,2019,3,F,C
4803,Alvin Williams,1998,2007,9,G,
4804,Art Williams,1968,1975,7,G,
4805,Bernie Williams,1970,1974,4,G,
4806,Bob Williams,1956,1957,1,F,
4807,Brandon Williams,1998,2003,5,G,
4808,Brandon Williams,2022,2022,0,G,
4809,Buck Williams,1982,1998,16,F,C
4810,C.J. Williams,2018,2019,1,G,
4811,Charlie Williams,1968,1973,5,G,
4812,Chuck Williams,1971,1978,7,G,
4813,Chuckie Williams,1977,1977,0,G,
4814,Cliff Williams,1969,1969,0,G,
4815,Corey Williams,1993,1994,1,G,
4816,Deron Williams,2006,2017,11,G,
4817,Derrick Williams,2012,2018,6,F,
4818,Duck Williams,1980,1980,0,G,
4819,Earl Williams,1975,1979,4,C,F
4820,Elliot Williams,2012,2016,4,G,
4821,Eric Williams,1996,2007,11,F,
4822,Fly Williams,1975,1975,0,G,F
4823,Frank Williams,2003,2005,2,G,
4824,Freeman Williams,1979,1986,7,G,F
4825,Gene Williams,1970,1970,0,F,
4826,Grant Williams,2020,2022,2,F,
4827,Gus Williams,1976,1987,11,G,
4828,Guy Williams,1985,1986,1,F,
4829,Hank Williams,1975,1975,0,F,
4830,Herb Williams,1982,1999,17,C,F
4831,Hot Rod Williams,1987,1999,12,F,C
4832,Jason Williams,1999,2011,12,G,
4833,Jawad Williams,2009,2011,2,F,
4834,Jay Williams,2003,2003,0,G,
4835,Jayson Williams,1991,1999,8,F,C
4836,Jerome Williams,1997,2005,8,F,
4837,John Williams,1987,1995,8,F,C
4838,Johnathan Williams,2019,2020,1,F,
4839,Jordan Williams,2012,2012,0,F,
4840,Justin Williams,2007,2008,1,F,
4841,Kenny Williams,1991,1994,3,F,
4842,Kenrich Williams,2019,2022,3,G,F
4843,Kevin Williams,1984,1989,5,G,
4844,Lorenzo Williams,1993,2000,7,F,C
4845,Lou Williams,2006,2022,16,G,
4846,Marcus Williams,2007,2010,3,G,
4847,Marcus Williams,2008,2009,1,F,
4848,Marvin Williams,2006,2020,14,F,
4849,Matt Williams,2018,2018,0,G,
4850,Micheal Williams,1989,1999,10,G,
4851,Mike Williams,1990,1990,0,F,
4852,Milt Williams,1971,1975,4,G,
4853,Mo Williams,2004,2016,12,G,
4854,Monty Williams,1995,2003,8,F,
4855,Nate Williams,1972,1979,7,F,G
4856,Patrick Williams,2021,2022,1,F,
4857,Pete Williams,1986,1987,1,F,
4858,Ray Williams,1978,1987,9,G,
4859,Reggie Williams,1988,1997,9,F,G
4860,Reggie Williams,2010,2017,7,F,
4861,Rickey Williams,1983,1983,0,G,
4862,Rob Williams,1983,1984,1,G,
4863,Robert Williams,2019,2022,3,C,F
4864,Ron Williams,1969,1976,7,G,
4865,Sam Williams,1969,1970,1,G,
4866,Sam Williams,1982,1985,3,F,
4867,Scott Williams,1991,2005,14,F,C
4868,Sean Williams,2008,2012,4,C,F
4869,Shammond Williams,1999,2007,8,G,
4870,Shawne Williams,2007,2015,8,F,
4871,Shelden Williams,2007,2012,5,F,
4872,Sly Williams,1980,1986,6,F,G
4873,Terrence Williams,2010,2013,3,F,
4874,Travis Williams,1998,1999,1,F,
4875,Troy Williams,2017,2019,2,F,
4876,Walt Williams,1993,2003,10,F,G
4877,Ward Williams,1949,1949,0,F,
4878,Willie Williams,1971,1971,0,F,
4879,Ziaire Williams,2022,2022,0,F,
4880,Nigel Williams-Goss,2020,2020,0,G,
4881,Corliss Williamson,1996,2007,11,F,
4882,John Williamson,1974,1981,7,G,
4883,Zion Williamson,2020,2021,1,F,C
4884,Vann Williford,1971,1971,0,F,
4885,Kevin Willis,1985,2007,22,F,C
4886,Bill Willoughby,1976,1984,8,F,C
4887,Dedric Willoughby,2000,2000,0,G,F
4888,Bob Wilson,1952,1952,0,G,
4889,Bobby Wilson,1968,1968,0,F,
4890,Bobby Wilson,1975,1978,3,G,
4891,Bubba Wilson,1980,1980,0,G,
4892,D.J. Wilson,2018,2022,4,F,
4893,George Wilson,1965,1971,6,C,
4894,Isaiah Wilson,1972,1973,1,G,
4895,Jamil Wilson,2018,2018,0,F,
4896,Jasper Wilson,1969,1970,1,F,
4897,Jim Wilson,1971,1971,0,G,
4898,Michael Wilson,1984,1987,3,G,
4899,Nikita Wilson,1988,1988,0,F,
4900,Othell Wilson,1985,1987,2,G,
4901,Rick Wilson,1979,1980,1,G,
4902,Ricky Wilson,1988,1988,0,G,
4903,Stephen Wilson,1971,1972,1,G,
4904,Trevor Wilson,1991,1996,5,F,
4905,Kyle Wiltjer,2017,2017,0,F,
4906,Kennard Winchester,1991,1993,2,G,F
4907,Tony Windis,1960,1960,0,G,
4908,Dylan Windler,2021,2022,1,G,F
4909,John Windsor,1964,1964,0,F,
4910,Lee Winfield,1970,1976,6,G,
4911,David Wingate,1987,2001,14,G,F
4912,Dontonio Wingfield,1995,1998,3,F,
4913,Harthorne Wingo,1973,1976,3,F,
4914,Marv Winkler,1971,1972,1,G,
4915,Justise Winslow,2016,2022,6,F,
4916,Rickie Winslow,1988,1988,0,F,
4917,Cassius Winston,2021,2022,1,G,
4918,Trevor Winter,1999,1999,0,C,
4919,Brian Winters,1975,1983,8,G,F
4920,Voise Winters,1986,1986,0,F,
4921,Skip Wise,1976,1976,0,G,
4922,Willie Wise,1970,1978,8,F,
4923,James Wiseman,2021,2021,0,C,
4924,Jeff Withey,2014,2018,4,C,
4925,Luke Witte,1974,1976,2,C,
4926,Greg Wittman,1970,1971,1,F,
4927,Randy Wittman,1984,1992,8,G,F
4928,Garry Witts,1982,1982,0,G,F
4929,Dave Wohl,1972,1978,6,G,
4930,Joe Wolf,1988,1999,11,F,C
4931,Rubén Wolkowyski,2001,2003,2,F,
4932,Nate Wolters,2014,2018,4,G,
4933,Al Wood,1982,1987,5,G,F
4934,Bob Wood,1950,1950,0,G,
4935,Christian Wood,2016,2022,6,F,
4936,David Wood,1989,1997,8,F,
4937,Howard Wood,1982,1982,0,F,
4938,Leon Wood,1985,1991,6,G,
4939,Robert Woodard II,2021,2022,1,F,
4940,Loren Woods,2002,2008,6,F,C
4941,Qyntel Woods,2003,2006,3,F,
4942,Randy Woods,1993,1996,3,G,
4943,Tommy Woods,1968,1968,0,F,
4944,Mike Woodson,1981,1991,10,G,F
4945,Bob Woollard,1970,1970,0,C,
4946,Orlando Woolridge,1982,1994,12,F,
4947,Haywoode Workman,1990,2000,10,G,
4948,Mark Workman,1953,1954,1,F,C
4949,Tom Workman,1968,1971,3,F,C
4950,Metta World Peace,2000,2017,17,F,
4951,Willie Worsley,1969,1969,0,G,
4952,Sam Worthen,1981,1982,1,G,
4953,James Worthy*,1983,1994,11,F,
4954,Antoine Wright,2006,2011,5,G,F
4955,Bracey Wright,2006,2007,1,G,
4956,Brad Wright,1987,1988,1,F,
4957,Brandan Wright,2008,2018,10,F,C
4958,Chris Wright,2012,2014,2,F,
4959,Chris Wright,2013,2013,0,G,
4960,Delon Wright,2016,2022,6,G,
4961,Dorell Wright,2005,2015,10,F,G
4962,Howard Wright,1991,1993,2,F,
4963,Howie Wright,1971,1972,1,G,
4964,Joby Wright,1973,1976,3,F,C
4965,Julian Wright,2008,2011,3,F,
4966,Larry Wright,1977,1982,5,G,
4967,Leroy Wright,1968,1969,1,F,
4968,Lonnie Wright,1968,1972,4,G,
4969,Lorenzen Wright,1997,2009,12,F,C
4970,Luther Wright,1994,1994,0,C,
4971,McKinley Wright IV,2022,2022,0,G,
4972,Moses Wright,2022,2022,0,F,
4973,Sharone Wright,1995,1998,3,F,C
4974,Justin Wright-Foreman,2020,2020,0,G,
4975,Tony Wroten,2013,2016,3,G,
4976,Dennis Wuycik,1973,1975,2,F,
4977,A.J. Wynder,1991,1991,0,G,
4978,Guerschon Yabusele,2018,2019,1,F,
4979,Vincent Yarbrough,2003,2003,0,G,F
4980,George Yardley*,1954,1960,6,F,G
4981,Barry Yates,1972,1972,0,F,
4982,Wayne Yates,1962,1962,0,C,
4983,Charlie Yelverton,1972,1972,0,G,F
4984,Rich Yonakor,1982,1982,0,F,
4985,Danny Young,1985,1995,10,G,
4986,James Young,2015,2018,3,G,F
4987,Joe Young,2016,2018,2,G,
4988,Korleone Young,1999,1999,0,F,
4989,Michael Young,1985,1990,5,F,G
4990,Nick Young,2008,2019,11,G,F
4991,Perry Young,1987,1987,0,G,
4992,Sam Young,2010,2013,3,F,
4993,Thaddeus Young,2008,2022,14,F,
4994,Tim Young,2000,2000,0,C,
4995,Trae Young,2019,2022,3,G,
4996,Sun Yue,2009,2009,0,G,
4997,Omer Yurtseven,2022,2022,0,C,
4998,Max Zaslofsky,1947,1956,9,G,F
4999,Zeke Zawoluk,1953,1955,2,F,C
5000,Cody Zeller,2014,2022,8,C,F
5001,Dave Zeller,1962,1962,0,G,
5002,Gary Zeller,1971,1972,1,G,
5003,Harry Zeller,1947,1947,0,C,F
5004,Luke Zeller,2013,2013,0,C,
5005,Tyler Zeller,2013,2020,7,F,C
5006,Tony Zeno,1980,1980,0,F,
5007,Phil Zevenbergen,1988,1988,0,C,
5008,Wang Zhizhi,2001,2005,4,C,
5009,George Zídek,1996,1998,2,C,
5010,Derrick Zimmerman,2006,2006,0,G,
5011,Stephen Zimmerman,2017,2017,0,C,
5012,Paul Zipser,2017,2018,1,G,F
5013,Ante Žižić,2018,2020,2,F,C
5014,Jim Zoet,1983,1983,0,C,
5015,Bill Zopf,1971,1971,0,G,
5016,Ivica Zubac,2017,2022,5,C,
5017,Matt Zunic,1949,1949,0,G,F
